Game_ID,Away_Team,Home_Team,Date,Ref_Crew,Accepted_Count,Yards,Away_Count,Away_Yards,Home_Count,Home_Yards,Total_Flags,Week,Year
1,Tennessee,Pittsburgh,9/10/2009,Bill Leavy,11,88,5,28,6,60,13,1,2009
2,Miami,Atlanta,9/13/2009,Walt Coleman,8,62,4,27,4,35,11,1,2009
3,Kansas City,Baltimore,9/13/2009,Gene Steratore,11,80,3,15,8,65,14,1,2009
4,Philadelphia,Carolina,9/13/2009,Jeff Triplette,14,106,9,76,5,30,14,1,2009
5,Denver,Cincinnati,9/13/2009,Jerome Boger,10,66,6,39,4,27,12,1,2009
6,Minnesota,Cleveland,9/13/2009,John Parry,11,104,3,38,8,66,12,1,2009
7,N.Y. Jets,Houston,9/13/2009,Ed Hochuli,16,117,10,80,6,37,19,1,2009
8,Jacksonville,Indianapolis,9/13/2009,Tony Corrente,6,41,3,24,3,17,6,1,2009
9,Detroit,New Orleans,9/13/2009,Mike Carey,15,116,8,80,7,36,17,1,2009
10,Dallas,Tampa Bay,9/13/2009,Al Riveron,7,56,4,41,3,15,9,1,2009
11,San Francisco,Arizona,9/13/2009,Don Carey,16,113,4,31,12,82,16,1,2009
12,Washington,N.Y. Giants,9/13/2009,Terry McAulay,8,62,4,32,4,30,12,1,2009
13,St. Louis,Seattle,9/13/2009,Pete Morelli,14,110,10,85,4,25,15,1,2009
14,Chicago,Green Bay,9/13/2009,Ron Winter,9,70,3,25,6,45,9,1,2009
15,Buffalo,New England,9/14/2009,Scott Green,15,126,9,71,6,55,16,1,2009
16,San Diego,Oakland,9/14/2009,Carl Cheffers,15,100,9,60,6,40,15,1,2009
17,Carolina,Atlanta,9/20/2009,Don Carey,12,75,6,35,6,40,14,2,2009
18,Minnesota,Detroit,9/20/2009,Carl Cheffers,11,88,5,43,6,45,12,2,2009
19,Cincinnati,Green Bay,9/20/2009,Ed Hochuli,24,176,13,100,11,76,27,2,2009
20,Arizona,Jacksonville,9/20/2009,Gene Steratore,15,108,7,58,8,50,15,2,2009
21,Oakland,Kansas City,9/20/2009,Walt Anderson,16,115,7,45,9,70,18,2,2009
22,New England,N.Y. Jets,9/20/2009,John Parry,19,144,11,89,8,55,21,2,2009
23,New Orleans,Philadelphia,9/20/2009,Al Riveron,10,58,3,13,7,45,16,2,2009
24,Houston,Tennessee,9/20/2009,Walt Coleman,14,104,6,40,8,64,23,2,2009
25,St. Louis,Washington,9/20/2009,Jerome Boger,11,80,6,45,5,35,13,2,2009
26,Tampa Bay,Buffalo,9/20/2009,Ron Winter,20,167,13,112,7,55,24,2,2009
27,Seattle,San Francisco,9/20/2009,Bill Leavy,12,99,6,45,6,54,13,2,2009
28,Pittsburgh,Chicago,9/20/2009,Scott Green,16,132,6,52,10,80,17,2,2009
29,Cleveland,Denver,9/20/2009,Pete Morelli,9,93,4,43,5,50,9,2,2009
30,Baltimore,San Diego,9/20/2009,Tony Corrente,16,117,4,32,12,85,18,2,2009
31,N.Y. Giants,Dallas,9/20/2009,Mike Carey,8,90,4,40,4,50,9,2,2009
32,Indianapolis,Miami,9/21/2009,Terry McAulay,8,40,4,20,4,20,10,2,2009
33,Cleveland,Baltimore,9/27/2009,Terry McAulay,13,130,5,46,8,84,19,3,2009
34,Pittsburgh,Cincinnati,9/27/2009,Gene Steratore,9,81,5,51,4,30,11,3,2009
35,Washington,Detroit,9/27/2009,Scott Green,17,155,9,97,8,58,17,3,2009
36,Jacksonville,Houston,9/27/2009,Ron Winter,10,100,5,40,5,60,11,3,2009
37,San Francisco,Minnesota,9/27/2009,Jerome Boger,16,112,7,60,9,52,18,3,2009
38,Atlanta,New England,9/27/2009,Al Riveron,9,64,7,54,2,10,9,3,2009
39,Kansas City,Philadelphia,9/27/2009,John Parry,13,110,10,90,3,20,14,3,2009
40,Green Bay,St. Louis,9/27/2009,Walt Coleman,12,91,6,51,6,40,14,3,2009
41,N.Y. Giants,Tampa Bay,9/27/2009,Jeff Triplette,10,85,5,60,5,25,12,3,2009
42,New Orleans,Buffalo,9/27/2009,Walt Anderson,21,213,9,97,12,116,23,3,2009
43,Chicago,Seattle,9/27/2009,Don Carey,11,105,7,60,4,45,12,3,2009
44,Tennessee,N.Y. Jets,9/27/2009,Mike Carey,6,40,3,15,3,25,6,3,2009
45,Denver,Oakland,9/27/2009,Ed Hochuli,11,83,5,30,6,53,15,3,2009
46,Miami,San Diego,9/27/2009,Bill Leavy,10,59,7,39,3,20,10,3,2009
47,Indianapolis,Arizona,9/27/2009,Pete Morelli,12,104,7,69,5,35,15,3,2009
48,Carolina,Dallas,9/28/2009,Tony Corrente,15,140,6,60,9,80,15,3,2009
49,Detroit,Chicago,10/4/2009,Walt Coleman,10,87,7,51,3,36,13,4,2009
50,Cincinnati,Cleveland,10/4/2009,Scott Green,11,90,6,46,5,44,15,4,2009
51,Oakland,Houston,10/4/2009,Don Carey,10,65,9,60,1,5,13,4,2009
52,Seattle,Indianapolis,10/4/2009,Mike Carey,13,93,6,45,7,48,14,4,2009
53,Tennessee,Jacksonville,10/4/2009,Al Riveron,10,98,6,68,4,30,11,4,2009
54,N.Y. Giants,Kansas City,10/4/2009,Jerome Boger,15,109,8,54,7,55,21,4,2009
55,Baltimore,New England,10/4/2009,Ron Winter,14,126,9,85,5,41,18,4,2009
56,Tampa Bay,Washington,10/4/2009,Ed Hochuli,9,80,5,40,4,40,10,4,2009
57,Buffalo,Miami,10/4/2009,Carl Cheffers,8,64,3,19,5,45,9,4,2009
58,N.Y. Jets,New Orleans,10/4/2009,Bill Leavy,10,91,3,21,7,70,10,4,2009
59,Dallas,Denver,10/4/2009,Walt Anderson,17,151,7,70,10,81,18,4,2009
60,St. Louis,San Francisco,10/4/2009,Tony Corrente,13,106,10,73,3,33,15,4,2009
61,San Diego,Pittsburgh,10/4/2009,Jeff Triplette,9,79,3,20,6,59,11,4,2009
62,Green Bay,Minnesota,10/5/2009,Gene Steratore,9,67,7,57,2,10,12,4,2009
63,Cincinnati,Baltimore,10/11/2009,Jeff Triplette,17,115,7,39,10,76,19,5,2009
64,Cleveland,Buffalo,10/11/2009,Jerome Boger,16,104,3,29,13,75,19,5,2009
65,Washington,Carolina,10/11/2009,Walt Coleman,9,47,4,20,5,27,11,5,2009
66,Pittsburgh,Detroit,10/11/2009,Ed Hochuli,12,125,6,59,6,66,15,5,2009
67,Dallas,Kansas City,10/11/2009,Ron Winter,20,140,13,90,7,50,23,5,2009
68,Oakland,N.Y. Giants,10/11/2009,John Parry,11,104,7,67,4,37,12,5,2009
69,Tampa Bay,Philadelphia,10/11/2009,Terry McAulay,14,141,4,30,10,111,17,5,2009
70,Minnesota,St. Louis,10/11/2009,Don Carey,12,126,5,44,7,82,14,5,2009
71,Atlanta,San Francisco,10/11/2009,Pete Morelli,16,182,8,90,8,92,20,5,2009
72,Houston,Arizona,10/11/2009,Tony Corrente,13,93,6,53,7,40,13,5,2009
73,New England,Denver,10/11/2009,Carl Cheffers,7,66,4,46,3,20,13,5,2009
74,Jacksonville,Seattle,10/11/2009,Scott Green,10,83,9,73,1,10,13,5,2009
75,Indianapolis,Tennessee,10/11/2009,Walt Anderson,16,137,7,48,9,89,19,5,2009
76,N.Y. Jets,Miami,10/12/2009,Al Riveron,14,168,6,56,8,112,15,5,2009
77,Houston,Cincinnati,10/18/2009,Bill Leavy,11,105,7,60,4,45,16,6,2009
78,Detroit,Green Bay,10/18/2009,Jerome Boger,19,170,6,40,13,130,22,6,2009
79,St. Louis,Jacksonville,10/18/2009,Jeff Triplette,8,62,6,52,2,10,8,6,2009
80,Baltimore,Minnesota,10/18/2009,Mike Carey,9,89,6,74,3,15,15,6,2009
81,N.Y. Giants,New Orleans,10/18/2009,Ed Hochuli,15,165,9,110,6,55,17,6,2009
82,Cleveland,Pittsburgh,10/18/2009,Walt Anderson,8,75,4,45,4,30,9,6,2009
83,Carolina,Tampa Bay,10/18/2009,John Parry,8,70,3,30,5,40,10,6,2009
84,Kansas City,Washington,10/18/2009,Tony Corrente,11,93,4,30,7,63,11,6,2009
85,Philadelphia,Oakland,10/18/2009,Pete Morelli,7,61,4,38,3,23,10,6,2009
86,Arizona,Seattle,10/18/2009,Carl Cheffers,13,132,7,76,6,56,14,6,2009
87,Tennessee,New England,10/18/2009,Gene Steratore,12,95,6,55,6,40,12,6,2009
88,Buffalo,N.Y. Jets,10/18/2009,Walt Coleman,22,160,8,64,14,96,27,6,2009
89,Chicago,Atlanta,10/18/2009,Terry McAulay,15,135,9,65,6,70,17,6,2009
90,Denver,San Diego,10/19/2009,Scott Green,8,92,4,48,4,44,13,6,2009
91,Chicago,Cincinnati,10/25/2009,Walt Anderson,9,64,6,44,3,20,11,7,2009
92,Green Bay,Cleveland,10/25/2009,Don Carey,13,110,8,70,5,40,13,7,2009
93,San Francisco,Houston,10/25/2009,Mike Carey,18,142,11,65,7,77,22,7,2009
94,San Diego,Kansas City,10/25/2009,Pete Morelli,16,100,9,59,7,41,16,7,2009
95,Minnesota,Pittsburgh,10/25/2009,Ron Winter,14,93,11,78,3,15,16,7,2009
96,Indianapolis,St. Louis,10/25/2009,Carl Cheffers,11,124,6,51,5,73,11,7,2009
97,New England,Tampa Bay,10/25/2009,Jerome Boger,16,121,10,66,6,55,18,7,2009
98,Buffalo,Carolina,10/25/2009,Terry McAulay,12,89,3,22,9,67,14,7,2009
99,N.Y. Jets,Oakland,10/25/2009,Gene Steratore,5,32,2,8,3,24,7,7,2009
100,Atlanta,Dallas,10/25/2009,Scott Green,11,80,3,30,8,50,15,7,2009
101,New Orleans,Miami,10/25/2009,John Parry,14,80,6,25,8,55,16,7,2009
102,Arizona,N.Y. Giants,10/25/2009,Al Riveron,14,90,7,60,7,30,14,7,2009
103,Philadelphia,Washington,10/26/2009,Bill Leavy,18,126,12,66,6,60,19,7,2009
104,Denver,Baltimore,11/1/2009,Walt Coleman,14,129,6,35,8,94,14,8,2009
105,Houston,Buffalo,11/1/2009,Gene Steratore,9,81,5,45,4,36,9,8,2009
106,Cleveland,Chicago,11/1/2009,Al Riveron,8,65,3,30,5,35,8,8,2009
107,Seattle,Dallas,11/1/2009,Jerome Boger,11,96,6,53,5,43,11,8,2009
108,St. Louis,Detroit,11/1/2009,Ron Winter,13,94,5,27,8,67,17,8,2009
109,Minnesota,Green Bay,11/1/2009,Tony Corrente,9,74,3,29,6,45,13,8,2009
110,San Francisco,Indianapolis,11/1/2009,Ed Hochuli,12,88,7,50,5,38,12,8,2009
111,Miami,N.Y. Jets,11/1/2009,Don Carey,10,65,4,25,6,40,11,8,2009
112,Oakland,San Diego,11/1/2009,Terry McAulay,11,71,6,31,5,40,12,8,2009
113,Jacksonville,Tennessee,11/1/2009,Pete Morelli,6,47,2,27,4,20,9,8,2009
114,Carolina,Arizona,11/1/2009,Mike Carey,12,107,7,72,5,35,14,8,2009
115,N.Y. Giants,Philadelphia,11/1/2009,Carl Cheffers,9,70,4,25,5,45,14,8,2009
116,Atlanta,New Orleans,11/2/2009,Jeff Triplette,11,90,4,25,7,65,13,8,2009
117,Washington,Atlanta,11/8/2009,Ron Winter,17,142,10,88,7,54,19,9,2009
118,Arizona,Chicago,11/8/2009,Ed Hochuli,11,104,2,15,9,89,12,9,2009
119,Baltimore,Cincinnati,11/8/2009,Al Riveron,13,120,7,80,6,40,15,9,2009
120,Houston,Indianapolis,11/8/2009,Jeff Triplette,17,143,13,103,4,40,22,9,2009
121,Kansas City,Jacksonville,11/8/2009,Bill Leavy,6,41,1,10,5,31,8,9,2009
122,Miami,New England,11/8/2009,Mike Carey,8,84,3,35,5,49,13,9,2009
123,Green Bay,Tampa Bay,11/8/2009,Pete Morelli,7,50,5,35,2,15,9,9,2009
124,Carolina,New Orleans,11/8/2009,Scott Green,13,92,6,37,7,55,14,9,2009
125,Detroit,Seattle,11/8/2009,John Parry,15,122,9,77,6,45,18,9,2009
126,San Diego,N.Y. Giants,11/8/2009,Walt Anderson,12,124,3,20,9,104,17,9,2009
127,Tennessee,San Francisco,11/8/2009,Carl Cheffers,13,83,8,58,5,25,16,9,2009
128,Dallas,Philadelphia,11/8/2009,Walt Coleman,19,152,11,70,8,82,19,9,2009
129,Pittsburgh,Denver,11/9/2009,Don Carey,7,53,4,28,3,25,8,9,2009
130,Chicago,San Francisco,11/12/2009,Ron Winter,19,152,10,75,9,77,24,10,2009
131,Atlanta,Carolina,11/15/2009,Bill Leavy,9,74,4,26,5,48,12,10,2009
132,Tampa Bay,Miami,11/15/2009,Tony Corrente,12,107,9,77,3,30,14,10,2009
133,Detroit,Minnesota,11/15/2009,Walt Anderson,17,131,4,40,13,91,21,10,2009
134,Jacksonville,N.Y. Jets,11/15/2009,Ed Hochuli,9,66,5,40,4,26,10,10,2009
135,Cincinnati,Pittsburgh,11/15/2009,Terry McAulay,12,137,7,87,5,50,13,10,2009
136,New Orleans,St. Louis,11/15/2009,Gene Steratore,10,60,6,40,4,20,12,10,2009
137,Buffalo,Tennessee,11/15/2009,John Parry,18,140,10,65,8,75,22,10,2009
138,Denver,Washington,11/15/2009,Pete Morelli,6,64,4,45,2,19,8,10,2009
139,Kansas City,Oakland,11/15/2009,Mike Carey,15,123,5,35,10,88,19,10,2009
140,Seattle,Arizona,11/15/2009,Walt Coleman,20,249,9,113,11,136,26,10,2009
141,Dallas,Green Bay,11/15/2009,Jeff Triplette,22,167,10,67,12,100,27,10,2009
142,Philadelphia,San Diego,11/15/2009,Jerome Boger,12,101,9,70,3,31,14,10,2009
143,New England,Indianapolis,11/15/2009,Scott Green,7,92,4,72,3,20,8,10,2009
144,Baltimore,Cleveland,11/16/2009,Carl Cheffers,13,95,7,43,6,52,17,10,2009
145,Miami,Carolina,11/19/2009,Walt Anderson,9,65,5,30,4,35,9,11,2009
146,Indianapolis,Baltimore,11/22/2009,John Parry,7,60,5,40,2,20,7,11,2009
147,Washington,Dallas,11/22/2009,Al Riveron,11,62,5,27,6,35,13,11,2009
148,Cleveland,Detroit,11/22/2009,Terry McAulay,16,110,8,69,8,41,17,11,2009
149,San Francisco,Green Bay,11/22/2009,Scott Green,10,94,4,30,6,64,11,11,2009
150,Buffalo,Jacksonville,11/22/2009,Mike Carey,12,93,6,43,6,50,13,11,2009
151,Pittsburgh,Kansas City,11/22/2009,Carl Cheffers,12,113,8,85,4,28,13,11,2009
152,Seattle,Minnesota,11/22/2009,Ed Hochuli,15,95,10,64,5,31,18,11,2009
153,Atlanta,N.Y. Giants,11/22/2009,Gene Steratore,11,80,3,16,8,64,16,11,2009
154,New Orleans,Tampa Bay,11/22/2009,Walt Coleman,7,73,4,55,3,18,7,11,2009
155,Arizona,St. Louis,11/22/2009,Bill Leavy,13,90,6,40,7,50,15,11,2009
156,San Diego,Denver,11/22/2009,Ron Winter,10,80,1,15,9,65,14,11,2009
157,N.Y. Jets,New England,11/22/2009,Jeff Triplette,11,79,5,28,6,51,14,11,2009
158,Cincinnati,Oakland,11/22/2009,Don Carey,11,72,8,59,3,13,12,11,2009
159,Philadelphia,Chicago,11/22/2009,Tony Corrente,15,110,8,46,7,64,15,11,2009
160,Tennessee,Houston,11/23/2009,Jerome Boger,12,97,5,25,7,72,14,11,2009
161,Green Bay,Detroit,11/26/2009,Bill Leavy,10,85,7,57,3,28,10,12,2009
162,Oakland,Dallas,11/26/2009,Carl Cheffers,13,118,7,70,6,48,14,12,2009
163,N.Y. Giants,Denver,11/26/2009,Tony Corrente,12,106,4,45,8,61,16,12,2009
164,Tampa Bay,Atlanta,11/29/2009,Walt Anderson,11,81,8,52,3,29,16,12,2009
165,Miami,Buffalo,11/29/2009,Jeff Triplette,9,70,6,50,3,20,11,12,2009
166,Cleveland,Cincinnati,11/29/2009,Mike Carey,14,105,4,30,10,75,16,12,2009
167,Indianapolis,Houston,11/29/2009,Al Riveron,13,154,3,25,10,129,13,12,2009
168,Chicago,Minnesota,11/29/2009,Walt Coleman,16,114,6,44,10,70,20,12,2009
169,Carolina,N.Y. Jets,11/29/2009,Jerome Boger,8,54,5,30,3,24,10,12,2009
170,Washington,Philadelphia,11/29/2009,Gene Steratore,14,99,7,39,7,60,18,12,2009
171,Seattle,St. Louis,11/29/2009,Scott Green,11,87,7,52,4,35,12,12,2009
172,Arizona,Tennessee,11/29/2009,Terry McAulay,10,63,4,25,6,38,10,12,2009
173,Kansas City,San Diego,11/29/2009,Don Carey,13,80,5,25,8,55,15,12,2009
174,Jacksonville,San Francisco,11/29/2009,John Parry,7,65,6,60,1,5,8,12,2009
175,Pittsburgh,Baltimore,11/29/2009,Ed Hochuli,14,139,5,59,9,80,16,12,2009
176,New England,New Orleans,11/30/2009,Pete Morelli,4,36,0,0,4,36,7,12,2009
177,N.Y. Jets,Buffalo,12/3/2009,Scott Green,4,23,3,18,1,5,4,13,2009
178,Philadelphia,Atlanta,12/6/2009,Ed Hochuli,14,92,8,62,6,30,20,13,2009
179,Tampa Bay,Carolina,12/6/2009,Don Carey,10,87,5,50,5,37,13,13,2009
180,St. Louis,Chicago,12/6/2009,Pete Morelli,10,120,6,85,4,35,10,13,2009
181,Detroit,Cincinnati,12/6/2009,Tony Corrente,16,120,7,45,9,75,20,13,2009
182,Tennessee,Indianapolis,12/6/2009,Ron Winter,9,90,4,50,5,40,9,13,2009
183,Houston,Jacksonville,12/6/2009,Terry McAulay,10,82,6,37,4,45,10,13,2009
184,Denver,Kansas City,12/6/2009,Jeff Triplette,6,45,3,20,3,25,10,13,2009
185,Oakland,Pittsburgh,12/6/2009,Jerome Boger,13,111,9,70,4,41,16,13,2009
186,New Orleans,Washington,12/6/2009,Carl Cheffers,9,117,7,102,2,15,10,13,2009
187,San Diego,Cleveland,12/6/2009,Walt Coleman,5,35,1,5,4,30,10,13,2009
188,Minnesota,Arizona,12/6/2009,John Parry,12,100,6,50,6,50,16,13,2009
189,Dallas,N.Y. Giants,12/6/2009,Bill Leavy,7,40,5,30,2,10,11,13,2009
190,San Francisco,Seattle,12/6/2009,Al Riveron,12,105,8,57,4,48,13,13,2009
191,New England,Miami,12/6/2009,Gene Steratore,8,92,6,82,2,10,10,13,2009
192,Baltimore,Green Bay,12/7/2009,Walt Anderson,23,310,12,135,11,175,24,13,2009
193,Pittsburgh,Cleveland,12/10/2009,Ron Winter,10,95,4,40,6,55,10,14,2009
194,New Orleans,Atlanta,12/13/2009,Tony Corrente,10,114,6,59,4,55,12,14,2009
195,Detroit,Baltimore,12/13/2009,Don Carey,9,90,4,40,5,50,10,14,2009
196,Green Bay,Chicago,12/13/2009,Mike Carey,17,139,4,30,13,109,18,14,2009
197,Seattle,Houston,12/13/2009,Pete Morelli,11,98,7,63,4,35,11,14,2009
198,Denver,Indianapolis,12/13/2009,Bill Leavy,11,85,7,65,4,20,11,14,2009
199,Miami,Jacksonville,12/13/2009,Walt Coleman,6,37,4,27,2,10,8,14,2009
200,Buffalo,Kansas City,12/13/2009,Al Riveron,8,83,3,40,5,43,11,14,2009
201,Cincinnati,Minnesota,12/13/2009,Scott Green,20,154,11,85,9,69,23,14,2009
202,Carolina,New England,12/13/2009,Terry McAulay,13,117,9,92,4,25,17,14,2009
203,N.Y. Jets,Tampa Bay,12/13/2009,Carl Cheffers,12,97,6,63,6,34,15,14,2009
204,St. Louis,Tennessee,12/13/2009,Jeff Triplette,14,122,10,82,4,40,19,14,2009
205,Washington,Oakland,12/13/2009,Walt Anderson,21,163,7,45,14,118,23,14,2009
206,San Diego,Dallas,12/13/2009,Gene Steratore,11,92,5,24,6,68,11,14,2009
207,Philadelphia,N.Y. Giants,12/13/2009,John Parry,13,99,6,45,7,54,16,14,2009
208,Arizona,San Francisco,12/14/2009,Jerome Boger,18,133,11,78,7,55,18,14,2009
209,Indianapolis,Jacksonville,12/17/2009,Walt Anderson,9,62,5,40,4,22,11,15,2009
210,Dallas,New Orleans,12/19/2009,Terry McAulay,10,79,6,49,4,30,11,15,2009
211,Chicago,Baltimore,12/20/2009,Bill Leavy,5,35,1,9,4,26,10,15,2009
212,New England,Buffalo,12/20/2009,Tony Corrente,17,176,6,52,11,124,18,15,2009
213,Arizona,Detroit,12/20/2009,Jeff Triplette,15,110,8,65,7,45,19,15,2009
214,Cleveland,Kansas City,12/20/2009,Gene Steratore,6,54,3,20,3,34,9,15,2009
215,Atlanta,N.Y. Jets,12/20/2009,Ron Winter,10,90,4,25,6,65,12,15,2009
216,San Francisco,Philadelphia,12/20/2009,Don Carey,12,124,8,55,4,69,15,15,2009
217,Green Bay,Pittsburgh,12/20/2009,John Parry,17,137,7,53,10,84,20,15,2009
218,Houston,St. Louis,12/20/2009,Ed Hochuli,7,45,4,30,3,15,10,15,2009
219,Miami,Tennessee,12/20/2009,Scott Green,12,106,8,60,4,46,14,15,2009
220,Oakland,Denver,12/20/2009,Al Riveron,16,134,9,62,7,72,16,15,2009
221,Cincinnati,San Diego,12/20/2009,Carl Cheffers,13,85,9,55,4,30,14,15,2009
222,Tampa Bay,Seattle,12/20/2009,Mike Carey,12,85,6,35,6,50,13,15,2009
223,Minnesota,Carolina,12/20/2009,Pete Morelli,11,94,5,45,6,49,12,15,2009
224,N.Y. Giants,Washington,12/21/2009,Walt Coleman,9,67,3,15,6,52,10,15,2009
225,San Diego,Tennessee,12/25/2009,Tony Corrente,15,119,6,45,9,74,15,16,2009
226,Buffalo,Atlanta,12/27/2009,Bill Leavy,16,130,10,60,6,70,17,16,2009
227,Kansas City,Cincinnati,12/27/2009,Ed Hochuli,12,76,6,40,6,36,13,16,2009
228,Oakland,Cleveland,12/27/2009,Jeff Triplette,19,190,13,126,6,64,24,16,2009
229,Seattle,Green Bay,12/27/2009,Walt Coleman,13,136,8,86,5,50,15,16,2009
230,Houston,Miami,12/27/2009,Ron Winter,7,45,3,15,4,30,10,16,2009
231,Carolina,N.Y. Giants,12/27/2009,Scott Green,8,49,4,20,4,29,11,16,2009
232,Jacksonville,New England,12/27/2009,Don Carey,3,15,1,5,2,10,3,16,2009
233,Tampa Bay,New Orleans,12/27/2009,Jerome Boger,9,56,7,42,2,14,11,16,2009
234,Denver,Philadelphia,12/27/2009,Mike Carey,18,154,9,95,9,59,20,16,2009
235,Baltimore,Pittsburgh,12/27/2009,Pete Morelli,15,133,11,113,4,20,17,16,2009
236,St. Louis,Arizona,12/27/2009,Al Riveron,7,35,4,20,3,15,9,16,2009
237,Detroit,San Francisco,12/27/2009,Walt Anderson,5,39,1,10,4,29,6,16,2009
238,N.Y. Jets,Indianapolis,12/27/2009,Terry McAulay,8,67,5,52,3,15,8,16,2009
239,Dallas,Washington,12/27/2009,John Parry,8,54,4,21,4,33,8,16,2009
240,Minnesota,Chicago,12/28/2009,Gene Steratore,7,78,4,47,3,31,10,16,2009
241,Indianapolis,Buffalo,1/3/2010,Don Carey,7,55,3,15,4,40,7,17,2009
242,New Orleans,Carolina,1/3/2010,Al Riveron,7,64,4,35,3,29,8,17,2009
243,Jacksonville,Cleveland,1/3/2010,Pete Morelli,6,35,3,20,3,15,6,17,2009
244,Philadelphia,Dallas,1/3/2010,Ron Winter,17,138,6,58,11,80,18,17,2009
245,Chicago,Detroit,1/3/2010,Jerome Boger,11,70,5,35,6,35,12,17,2009
246,New England,Houston,1/3/2010,John Parry,9,90,4,55,5,35,9,17,2009
247,Pittsburgh,Miami,1/3/2010,Bill Leavy,8,85,5,40,3,45,12,17,2009
248,N.Y. Giants,Minnesota,1/3/2010,Terry McAulay,21,140,13,95,8,45,21,17,2009
249,Cincinnati,N.Y. Jets,1/3/2010,Walt Anderson,11,64,7,44,4,20,13,17,2009
250,San Francisco,St. Louis,1/3/2010,Mike Carey,13,90,6,40,7,50,17,17,2009
251,Atlanta,Tampa Bay,1/3/2010,Gene Steratore,8,66,3,15,5,51,10,17,2009
252,Green Bay,Arizona,1/3/2010,Carl Cheffers,11,95,4,19,7,76,11,17,2009
253,Kansas City,Denver,1/3/2010,Scott Green,10,130,5,76,5,54,12,17,2009
254,Baltimore,Oakland,1/3/2010,Tony Corrente,10,67,5,37,5,30,10,17,2009
255,Washington,San Diego,1/3/2010,Jeff Triplette,5,31,3,14,2,17,5,17,2009
256,Tennessee,Seattle,1/3/2010,Ed Hochuli,14,116,9,76,5,40,16,17,2009
257,Minnesota,New Orleans,9/9/2010,Terry McAulay,9,80,6,60,3,20,15,1,2010
258,Cleveland,Tampa Bay,9/12/2010,Jeff Triplette,11,102,5,47,6,55,16,1,2010
259,Miami,Buffalo,9/12/2010,Clete Blakeman,8,50,3,15,5,35,8,1,2010
260,Cincinnati,New England,9/12/2010,Carl Cheffers,8,35,2,5,6,30,8,1,2010
261,Indianapolis,Houston,9/12/2010,Ed Hochuli,12,123,5,73,7,50,15,1,2010
262,Denver,Jacksonville,9/12/2010,Walt Coleman,12,117,7,70,5,47,13,1,2010
263,Oakland,Tennessee,9/12/2010,Bill Leavy,18,158,10,77,8,81,20,1,2010
264,Carolina,N.Y. Giants,9/12/2010,Jerome Boger,16,158,7,63,9,95,18,1,2010
265,Detroit,Chicago,9/12/2010,Gene Steratore,16,140,7,40,9,100,16,1,2010
266,Arizona,St. Louis,9/12/2010,Al Riveron,15,112,10,72,5,40,19,1,2010
267,Atlanta,Pittsburgh,9/12/2010,Scott Green,7,49,3,24,4,25,8,1,2010
268,Green Bay,Philadelphia,9/12/2010,John Parry,12,95,2,15,10,80,12,1,2010
269,San Francisco,Seattle,9/12/2010,Mike Carey,13,95,8,60,5,35,16,1,2010
270,Dallas,Washington,9/12/2010,Tony Corrente,17,133,12,91,5,42,21,1,2010
271,Baltimore,N.Y. Jets,9/13/2010,Walt Anderson,19,163,5,38,14,125,22,1,2010
272,San Diego,Kansas City,9/13/2010,Pete Morelli,8,65,5,30,3,35,8,1,2010
273,Houston,Washington,9/19/2010,Jeff Triplette,12,103,5,45,7,58,13,2,2010
274,Buffalo,Green Bay,9/19/2010,Ron Winter,10,84,4,35,6,49,14,2,2010
275,Miami,Minnesota,9/19/2010,Mike Carey,9,59,2,15,7,44,16,2,2010
276,Kansas City,Cleveland,9/19/2010,Carl Cheffers,13,108,4,30,9,78,14,2,2010
277,Pittsburgh,Tennessee,9/19/2010,John Parry,16,107,5,35,11,72,21,2,2010
278,Chicago,Dallas,9/19/2010,Scott Green,8,60,2,10,6,50,10,2,2010
279,Philadelphia,Detroit,9/19/2010,Clete Blakeman,18,126,9,75,9,51,21,2,2010
280,Arizona,Atlanta,9/19/2010,Jerome Boger,16,184,10,109,6,75,22,2,2010
281,Tampa Bay,Carolina,9/19/2010,Walt Coleman,8,78,4,30,4,48,11,2,2010
282,Seattle,Denver,9/19/2010,Walt Anderson,10,99,7,64,3,35,11,2,2010
283,St. Louis,Oakland,9/19/2010,Tony Corrente,20,182,8,92,12,90,22,2,2010
284,New England,N.Y. Jets,9/19/2010,Ed Hochuli,12,137,6,79,6,58,12,2,2010
285,Baltimore,Cincinnati,9/19/2010,Gene Steratore,14,101,5,45,9,56,18,2,2010
286,Jacksonville,San Diego,9/19/2010,Terry McAulay,9,58,5,33,4,25,9,2,2010
287,N.Y. Giants,Indianapolis,9/19/2010,Bill Leavy,9,80,3,25,6,55,11,2,2010
288,New Orleans,San Francisco,9/20/2010,Al Riveron,10,94,5,54,5,40,13,2,2010
289,Tennessee,N.Y. Giants,9/26/2010,Tony Corrente,19,166,8,80,11,86,22,3,2010
290,Cincinnati,Carolina,9/26/2010,Pete Morelli,14,114,8,69,6,45,14,3,2010
291,Pittsburgh,Tampa Bay,9/26/2010,Bill Leavy,6,65,2,20,4,45,8,3,2010
292,Buffalo,New England,9/26/2010,John Parry,10,80,6,45,4,35,10,3,2010
293,Cleveland,Baltimore,9/26/2010,Scott Green,16,120,8,60,8,60,17,3,2010
294,Detroit,Minnesota,9/26/2010,Ed Hochuli,20,167,8,67,12,100,25,3,2010
295,Atlanta,New Orleans,9/26/2010,Walt Anderson,10,78,6,40,4,38,11,3,2010
296,Washington,St. Louis,9/26/2010,Walt Coleman,18,164,9,65,9,99,23,3,2010
297,Dallas,Houston,9/26/2010,Carl Cheffers,13,81,8,49,5,32,22,3,2010
298,San Francisco,Kansas City,9/26/2010,Clete Blakeman,13,95,6,55,7,40,13,3,2010
299,Philadelphia,Jacksonville,9/26/2010,Jeff Triplette,11,151,7,84,4,67,14,3,2010
300,Indianapolis,Denver,9/26/2010,Al Riveron,10,87,4,27,6,60,11,3,2010
301,Oakland,Arizona,9/26/2010,Mike Carey,18,227,11,123,7,104,20,3,2010
302,San Diego,Seattle,9/26/2010,Ron Winter,16,115,11,83,5,32,16,3,2010
303,N.Y. Jets,Miami,9/26/2010,Jerome Boger,15,133,9,81,6,52,17,3,2010
304,Green Bay,Chicago,9/27/2010,Terry McAulay,23,190,18,152,5,38,25,3,2010
305,N.Y. Jets,Buffalo,10/3/2010,Bill Leavy,7,62,4,30,3,32,9,4,2010
306,Cincinnati,Cleveland,10/3/2010,Jerome Boger,15,123,8,79,7,44,15,4,2010
307,Baltimore,Pittsburgh,10/3/2010,Ed Hochuli,18,140,7,52,11,88,21,4,2010
308,Denver,Tennessee,10/3/2010,Clete Blakeman,16,185,6,74,10,111,19,4,2010
309,Detroit,Green Bay,10/3/2010,Mike Carey,16,133,13,102,3,31,20,4,2010
310,San Francisco,Atlanta,10/3/2010,Tony Corrente,10,101,6,41,4,60,12,4,2010
311,Carolina,New Orleans,10/3/2010,John Parry,8,102,4,66,4,36,8,4,2010
312,Seattle,St. Louis,10/3/2010,Pete Morelli,11,90,6,49,5,41,13,4,2010
313,Indianapolis,Jacksonville,10/3/2010,Ron Winter,10,80,3,35,7,45,10,4,2010
314,Houston,Oakland,10/3/2010,Scott Green,7,49,5,26,2,23,7,4,2010
315,Washington,Philadelphia,10/3/2010,Al Riveron,13,110,5,30,8,80,13,4,2010
316,Arizona,San Diego,10/3/2010,Gene Steratore,10,78,5,34,5,44,11,4,2010
317,Chicago,N.Y. Giants,10/3/2010,Carl Cheffers,14,84,8,40,6,44,15,4,2010
318,New England,Miami,10/4/2010,Walt Coleman,8,66,2,26,6,40,8,4,2010
319,Jacksonville,Buffalo,10/10/2010,Carl Cheffers,10,73,5,38,5,35,12,5,2010
320,Denver,Baltimore,10/10/2010,Jerome Boger,15,156,10,90,5,66,18,5,2010
321,Kansas City,Indianapolis,10/10/2010,Terry McAulay,9,83,4,38,5,45,10,5,2010
322,Green Bay,Washington,10/10/2010,Gene Steratore,13,91,9,63,4,28,13,5,2010
323,St. Louis,Detroit,10/10/2010,Bill Leavy,18,118,7,40,11,78,21,5,2010
324,Chicago,Carolina,10/10/2010,Mike Carey,12,98,5,45,7,53,17,5,2010
325,Tampa Bay,Cincinnati,10/10/2010,Scott Green,12,85,3,25,9,60,12,5,2010
326,Atlanta,Cleveland,10/10/2010,John Parry,13,118,6,60,7,58,14,5,2010
327,N.Y. Giants,Houston,10/10/2010,Walt Coleman,17,151,9,84,8,67,21,5,2010
328,New Orleans,Arizona,10/10/2010,Tony Corrente,9,65,6,45,3,20,13,5,2010
329,Tennessee,Dallas,10/10/2010,Jeff Triplette,16,173,4,40,12,133,19,5,2010
330,San Diego,Oakland,10/10/2010,Clete Blakeman,19,138,7,53,12,85,21,5,2010
331,Philadelphia,San Francisco,10/10/2010,Walt Anderson,15,95,5,30,10,65,17,5,2010
332,Minnesota,N.Y. Jets,10/11/2010,Pete Morelli,14,106,8,51,6,55,16,5,2010
333,Miami,Green Bay,10/17/2010,Ed Hochuli,11,75,4,30,7,45,12,6,2010
334,San Diego,St. Louis,10/17/2010,Scott Green,12,66,6,31,6,35,13,6,2010
335,Baltimore,New England,10/17/2010,Bill Leavy,17,145,8,67,9,78,21,6,2010
336,Cleveland,Pittsburgh,10/17/2010,Walt Anderson,8,71,4,46,4,25,11,6,2010
337,Kansas City,Houston,10/17/2010,Ron Winter,10,88,5,35,5,53,15,6,2010
338,Detroit,N.Y. Giants,10/17/2010,Jeff Triplette,13,106,11,91,2,15,14,6,2010
339,Atlanta,Philadelphia,10/17/2010,Walt Coleman,11,108,2,30,9,78,11,6,2010
340,Seattle,Chicago,10/17/2010,Al Riveron,7,101,5,83,2,18,8,6,2010
341,New Orleans,Tampa Bay,10/17/2010,Clete Blakeman,14,110,9,80,5,30,14,6,2010
342,N.Y. Jets,Denver,10/17/2010,Tony Corrente,11,155,6,74,5,81,15,6,2010
343,Oakland,San Francisco,10/17/2010,Carl Cheffers,19,203,8,60,11,143,21,6,2010
344,Dallas,Minnesota,10/17/2010,Gene Steratore,16,136,11,91,5,45,17,6,2010
345,Indianapolis,Washington,10/17/2010,John Parry,10,68,3,15,7,53,11,6,2010
346,Tennessee,Jacksonville,10/18/2010,Mike Carey,15,112,8,57,7,55,16,6,2010
347,Cincinnati,Atlanta,10/24/2010,Al Riveron,10,77,7,36,3,41,11,7,2010
348,Pittsburgh,Miami,10/24/2010,Gene Steratore,8,58,5,34,3,24,10,7,2010
349,Buffalo,Baltimore,10/24/2010,Pete Morelli,10,96,6,78,4,18,11,7,2010
350,Jacksonville,Kansas City,10/24/2010,Jerome Boger,13,135,6,43,7,92,13,7,2010
351,Cleveland,New Orleans,10/24/2010,Walt Coleman,10,123,4,30,6,93,10,7,2010
352,Washington,Chicago,10/24/2010,Walt Anderson,13,99,7,48,6,51,14,7,2010
353,San Francisco,Carolina,10/24/2010,Ron Winter,15,116,11,81,4,35,17,7,2010
354,St. Louis,Tampa Bay,10/24/2010,Mike Carey,18,137,6,45,12,92,21,7,2010
355,Philadelphia,Tennessee,10/24/2010,Ed Hochuli,16,137,10,100,6,37,19,7,2010
356,Arizona,Seattle,10/24/2010,Jeff Triplette,15,127,5,32,10,95,17,7,2010
357,New England,San Diego,10/24/2010,Tony Corrente,13,120,7,51,6,69,14,7,2010
358,Oakland,Denver,10/24/2010,Terry McAulay,15,158,10,94,5,64,18,7,2010
359,Minnesota,Green Bay,10/24/2010,Scott Green,8,60,6,40,2,20,8,7,2010
360,N.Y. Giants,Dallas,10/25/2010,John Parry,11,88,6,46,5,42,11,7,2010
361,Denver,San Francisco,10/31/2010,Scott Green,14,127,8,60,6,67,16,8,2010
362,Jacksonville,Dallas,10/31/2010,Clete Blakeman,9,56,6,36,3,20,9,8,2010
363,Miami,Cincinnati,10/31/2010,Terry McAulay,8,78,4,42,4,36,9,8,2010
364,Buffalo,Kansas City,10/31/2010,Al Riveron,10,85,5,35,5,50,11,8,2010
365,Washington,Detroit,10/31/2010,Jerome Boger,17,142,10,77,7,65,18,8,2010
366,Carolina,St. Louis,10/31/2010,Carl Cheffers,13,95,6,30,7,65,17,8,2010
367,Green Bay,N.Y. Jets,10/31/2010,Jeff Triplette,10,70,3,15,7,55,12,8,2010
368,Tennessee,San Diego,10/31/2010,Bill Leavy,18,142,10,80,8,62,19,8,2010
369,Minnesota,New England,10/31/2010,Walt Anderson,11,82,5,35,6,47,11,8,2010
370,Tampa Bay,Arizona,10/31/2010,Ron Winter,12,92,9,80,3,12,16,8,2010
371,Seattle,Oakland,10/31/2010,Ed Hochuli,18,160,7,55,11,105,19,8,2010
372,Pittsburgh,New Orleans,10/31/2010,Pete Morelli,7,73,4,38,3,35,9,8,2010
373,Houston,Indianapolis,11/1/2010,Tony Corrente,14,99,5,30,9,69,16,8,2010
374,N.Y. Jets,Detroit,11/7/2010,Al Riveron,22,201,11,99,11,102,26,9,2010
375,Miami,Baltimore,11/7/2010,John Parry,9,63,4,23,5,40,10,9,2010
376,New England,Cleveland,11/7/2010,Clete Blakeman,7,48,3,20,4,28,7,9,2010
377,San Diego,Houston,11/7/2010,Mike Carey,10,93,6,62,4,31,12,9,2010
378,Chicago,Buffalo,11/7/2010,Gene Steratore,11,78,7,45,4,33,13,9,2010
379,Arizona,Minnesota,11/7/2010,Bill Leavy,18,104,7,39,11,65,18,9,2010
380,Tampa Bay,Atlanta,11/7/2010,Terry McAulay,9,83,5,30,4,53,12,9,2010
381,New Orleans,Carolina,11/7/2010,Ed Hochuli,17,129,7,64,10,65,20,9,2010
382,N.Y. Giants,Seattle,11/7/2010,Pete Morelli,14,110,5,40,9,70,16,9,2010
383,Indianapolis,Philadelphia,11/7/2010,Carl Cheffers,21,184,7,59,14,125,24,9,2010
384,Kansas City,Oakland,11/7/2010,Jeff Triplette,27,240,12,100,15,140,33,9,2010
385,Dallas,Green Bay,11/7/2010,Walt Coleman,7,60,5,40,2,20,9,9,2010
386,Pittsburgh,Cincinnati,11/8/2010,Ron Winter,10,103,7,73,3,30,12,9,2010
387,Baltimore,Atlanta,11/11/2010,Ron Winter,7,56,6,51,1,5,9,10,2010
388,Tennessee,Miami,11/14/2010,Pete Morelli,9,118,5,55,4,63,10,10,2010
389,N.Y. Jets,Cleveland,11/14/2010,Terry McAulay,13,122,9,70,4,52,13,10,2010
390,Cincinnati,Indianapolis,11/14/2010,Walt Anderson,9,83,4,38,5,45,9,10,2010
391,Houston,Jacksonville,11/14/2010,Gene Steratore,16,111,8,49,8,62,19,10,2010
392,Minnesota,Chicago,11/14/2010,Tony Corrente,13,135,2,19,11,116,15,10,2010
393,Carolina,Tampa Bay,11/14/2010,Jerome Boger,17,151,7,71,10,80,19,10,2010
394,Detroit,Buffalo,11/14/2010,Walt Coleman,15,90,11,60,4,30,15,10,2010
395,Kansas City,Denver,11/14/2010,Mike Carey,9,68,6,40,3,28,12,10,2010
396,Dallas,N.Y. Giants,11/14/2010,Bill Leavy,13,129,5,60,8,69,18,10,2010
397,Seattle,Arizona,11/14/2010,Scott Green,16,101,6,51,10,50,16,10,2010
398,St. Louis,San Francisco,11/14/2010,Ed Hochuli,26,240,12,135,14,105,27,10,2010
399,New England,Pittsburgh,11/14/2010,Carl Cheffers,16,158,10,113,6,45,18,10,2010
400,Philadelphia,Washington,11/15/2010,Clete Blakeman,12,76,6,35,6,41,12,10,2010
401,Chicago,Miami,11/18/2010,Bill Leavy,10,90,5,45,5,45,11,11,2010
402,Baltimore,Carolina,11/21/2010,Al Riveron,10,74,3,20,7,54,11,11,2010
403,Houston,N.Y. Jets,11/21/2010,Jerome Boger,7,64,3,25,4,39,9,11,2010
404,Buffalo,Cincinnati,11/21/2010,Ed Hochuli,17,115,10,58,7,57,17,11,2010
405,Oakland,Pittsburgh,11/21/2010,Tony Corrente,21,218,7,55,14,163,28,11,2010
406,Cleveland,Jacksonville,11/21/2010,Pete Morelli,7,55,5,45,2,10,7,11,2010
407,Detroit,Dallas,11/21/2010,Carl Cheffers,16,115,10,76,6,39,17,11,2010
408,Green Bay,Minnesota,11/21/2010,Clete Blakeman,7,55,1,5,6,50,7,11,2010
409,Seattle,New Orleans,11/21/2010,Mike Carey,11,103,8,79,3,24,12,11,2010
410,Washington,Tennessee,11/21/2010,Terry McAulay,14,101,3,20,11,81,15,11,2010
411,Arizona,Kansas City,11/21/2010,Walt Coleman,16,119,11,96,5,23,16,11,2010
412,Atlanta,St. Louis,11/21/2010,Walt Anderson,10,84,3,30,7,54,13,11,2010
413,Tampa Bay,San Francisco,11/21/2010,John Parry,6,53,3,35,3,18,9,11,2010
414,Indianapolis,New England,11/21/2010,Gene Steratore,7,63,6,48,1,15,8,11,2010
415,N.Y. Giants,Philadelphia,11/21/2010,Ron Winter,16,173,6,54,10,119,16,11,2010
416,Denver,San Diego,11/22/2010,Jeff Triplette,13,96,8,56,5,40,17,11,2010
417,New England,Detroit,11/25/2010,Ron Winter,13,116,5,50,8,66,15,12,2010
418,New Orleans,Dallas,11/25/2010,Jerome Boger,8,49,4,30,4,19,11,12,2010
419,Cincinnati,N.Y. Jets,11/25/2010,Mike Carey,10,89,2,25,8,64,10,12,2010
420,Jacksonville,N.Y. Giants,11/28/2010,Terry McAulay,7,45,3,20,4,25,10,12,2010
421,Pittsburgh,Buffalo,11/28/2010,John Parry,14,127,10,107,4,20,17,12,2010
422,Tennessee,Houston,11/28/2010,Clete Blakeman,16,147,10,79,6,68,21,12,2010
423,Minnesota,Washington,11/28/2010,Ed Hochuli,9,50,3,15,6,35,10,12,2010
424,Philadelphia,Chicago,11/28/2010,Scott Green,9,75,3,19,6,56,9,12,2010
425,Green Bay,Atlanta,11/28/2010,Pete Morelli,12,116,8,66,4,50,13,12,2010
426,Tampa Bay,Baltimore,11/28/2010,Carl Cheffers,13,108,9,78,4,30,14,12,2010
427,Carolina,Cleveland,11/28/2010,Jeff Triplette,13,114,8,68,5,46,15,12,2010
428,Kansas City,Seattle,11/28/2010,Tony Corrente,8,76,5,50,3,26,9,12,2010
429,Miami,Oakland,11/28/2010,Walt Anderson,9,55,5,35,4,20,11,12,2010
430,St. Louis,Denver,11/28/2010,Bill Leavy,10,90,4,30,6,60,13,12,2010
431,San Diego,Indianapolis,11/28/2010,Al Riveron,5,55,4,40,1,15,6,12,2010
432,San Francisco,Arizona,11/29/2010,Gene Steratore,12,101,6,40,6,61,12,12,2010
433,Houston,Philadelphia,12/2/2010,Walt Anderson,15,110,4,25,11,85,19,13,2010
434,Buffalo,Minnesota,12/5/2010,Jerome Boger,10,74,6,54,4,20,12,13,2010
435,Cleveland,Miami,12/5/2010,Al Riveron,8,82,4,45,4,37,8,13,2010
436,Jacksonville,Tennessee,12/5/2010,Ron Winter,8,61,4,31,4,30,10,13,2010
437,Denver,Kansas City,12/5/2010,Carl Cheffers,12,95,4,35,8,60,14,13,2010
438,Washington,N.Y. Giants,12/5/2010,Walt Coleman,10,70,5,35,5,35,12,13,2010
439,Chicago,Detroit,12/5/2010,Ed Hochuli,10,67,4,25,6,42,12,13,2010
440,San Francisco,Green Bay,12/5/2010,Bill Leavy,11,72,6,32,5,40,15,13,2010
441,Atlanta,Tampa Bay,12/5/2010,Tony Corrente,15,157,6,55,9,102,16,13,2010
442,New Orleans,Cincinnati,12/5/2010,Jeff Triplette,18,143,11,100,7,43,19,13,2010
443,Oakland,San Diego,12/5/2010,John Parry,16,124,13,105,3,19,18,13,2010
444,Dallas,Indianapolis,12/5/2010,Pete Morelli,8,63,5,35,3,28,9,13,2010
445,St. Louis,Arizona,12/5/2010,Clete Blakeman,8,69,2,15,6,54,11,13,2010
446,Carolina,Seattle,12/5/2010,Gene Steratore,12,73,8,53,4,20,13,13,2010
447,Pittsburgh,Baltimore,12/5/2010,Terry McAulay,18,114,9,61,9,53,19,13,2010
448,N.Y. Jets,New England,12/6/2010,Scott Green,5,66,4,56,1,10,6,13,2010
449,Indianapolis,Tennessee,12/9/2010,John Parry,12,89,7,60,5,29,13,14,2010
450,New England,Chicago,12/12/2010,Mike Carey,8,73,4,43,4,30,8,14,2010
451,Cleveland,Buffalo,12/12/2010,Scott Green,8,54,2,10,6,44,9,14,2010
452,Cincinnati,Pittsburgh,12/12/2010,Walt Coleman,13,114,4,25,9,89,14,14,2010
453,Oakland,Jacksonville,12/12/2010,Al Riveron,10,77,4,25,6,52,11,14,2010
454,Tampa Bay,Washington,12/12/2010,Pete Morelli,6,39,2,14,4,25,6,14,2010
455,Green Bay,Detroit,12/12/2010,Gene Steratore,9,55,3,20,6,35,13,14,2010
456,Atlanta,Carolina,12/12/2010,Clete Blakeman,7,60,1,10,6,50,7,14,2010
457,St. Louis,New Orleans,12/12/2010,Tony Corrente,9,94,4,39,5,55,9,14,2010
458,Seattle,San Francisco,12/12/2010,Carl Cheffers,10,90,8,75,2,15,11,14,2010
459,Miami,N.Y. Jets,12/12/2010,Ron Winter,11,86,5,36,6,50,13,14,2010
460,Denver,Arizona,12/12/2010,Jerome Boger,15,128,8,66,7,62,19,14,2010
461,Kansas City,San Diego,12/12/2010,Walt Anderson,8,62,2,15,6,47,10,14,2010
462,Philadelphia,Dallas,12/12/2010,Terry McAulay,11,99,6,59,5,40,12,14,2010
463,Baltimore,Houston,12/13/2010,Bill Leavy,11,66,3,15,8,51,12,14,2010
464,N.Y. Giants,Minnesota,12/12/2010,Jeff Triplette,17,126,7,55,10,71,21,14,2010
465,San Francisco,San Diego,12/16/2010,Clete Blakeman,9,95,5,60,4,35,9,15,2010
466,Kansas City,St. Louis,12/19/2010,Ron Winter,14,100,5,40,9,60,18,15,2010
467,Buffalo,Miami,12/19/2010,Jeff Triplette,9,79,5,44,4,35,11,15,2010
468,Cleveland,Cincinnati,12/19/2010,Jerome Boger,9,80,3,25,6,55,15,15,2010
469,Jacksonville,Indianapolis,12/19/2010,Mike Carey,12,123,6,55,6,68,13,15,2010
470,Houston,Tennessee,12/19/2010,Gene Steratore,21,142,9,66,12,76,23,15,2010
471,Washington,Dallas,12/19/2010,Al Riveron,12,95,3,25,9,70,12,15,2010
472,Philadelphia,N.Y. Giants,12/19/2010,John Parry,9,65,5,30,4,35,10,15,2010
473,Arizona,Carolina,12/19/2010,Tony Corrente,10,97,4,39,6,58,12,15,2010
474,Detroit,Tampa Bay,12/19/2010,Terry McAulay,16,122,7,57,9,65,17,15,2010
475,New Orleans,Baltimore,12/19/2010,Walt Anderson,15,136,5,68,10,68,19,15,2010
476,Atlanta,Seattle,12/19/2010,Walt Coleman,14,111,4,35,10,76,16,15,2010
477,N.Y. Jets,Pittsburgh,12/19/2010,Pete Morelli,6,54,3,19,3,35,8,15,2010
478,Denver,Oakland,12/19/2010,Scott Green,19,177,10,93,9,84,21,15,2010
479,Green Bay,New England,12/19/2010,Ed Hochuli,9,67,2,15,7,52,10,15,2010
480,Chicago,Minnesota,12/20/2010,Carl Cheffers,11,127,5,72,6,55,19,15,2010
481,Carolina,Pittsburgh,12/23/2010,Bill Leavy,10,102,6,62,4,40,13,16,2010
482,Dallas,Arizona,12/25/2010,Jeff Triplette,13,92,7,49,6,43,15,16,2010
483,N.Y. Jets,Chicago,12/26/2010,Walt Coleman,9,65,3,34,6,31,10,16,2010
484,New England,Buffalo,12/26/2010,Al Riveron,12,80,6,40,6,40,12,16,2010
485,Baltimore,Cleveland,12/26/2010,John Parry,3,25,1,5,2,20,6,16,2010
486,Tennessee,Kansas City,12/26/2010,Scott Green,16,158,9,74,7,84,24,16,2010
487,Seattle,Tampa Bay,12/26/2010,Clete Blakeman,4,32,1,10,3,22,4,16,2010
488,San Francisco,St. Louis,12/26/2010,Pete Morelli,13,128,8,87,5,41,16,16,2010
489,Detroit,Miami,12/26/2010,Tony Corrente,14,116,6,53,8,63,16,16,2010
490,Washington,Jacksonville,12/26/2010,Jerome Boger,12,106,5,40,7,66,14,16,2010
491,Houston,Denver,12/26/2010,Ron Winter,7,51,3,24,4,27,8,16,2010
492,Indianapolis,Oakland,12/26/2010,Terry McAulay,14,158,4,42,10,116,15,16,2010
493,N.Y. Giants,Green Bay,12/26/2010,Walt Anderson,8,76,5,45,3,31,8,16,2010
494,San Diego,Cincinnati,12/26/2010,Gene Steratore,7,62,1,5,6,57,9,16,2010
495,New Orleans,Atlanta,12/27/2010,Ed Hochuli,9,102,8,92,1,10,15,16,2010
496,Minnesota,Philadelphia,12/28/2010,Mike Carey,17,136,5,74,12,62,18,16,2010
497,Miami,New England,1/2/2011,Terry McAulay,10,112,5,40,5,72,10,17,2010
498,Buffalo,N.Y. Jets,1/2/2011,Carl Cheffers,6,40,3,15,3,25,8,17,2010
499,Cincinnati,Baltimore,1/2/2011,Pete Morelli,11,94,4,49,7,45,15,17,2010
500,Pittsburgh,Cleveland,1/2/2011,Ron Winter,9,71,3,25,6,46,12,17,2010
501,Jacksonville,Houston,1/2/2011,Jeff Triplette,7,63,2,15,5,48,7,17,2010
502,Tennessee,Indianapolis,1/2/2011,Ed Hochuli,12,83,7,58,5,25,14,17,2010
503,Oakland,Kansas City,1/2/2011,Bill Leavy,15,116,10,77,5,39,15,17,2010
504,Dallas,Philadelphia,1/2/2011,Tony Corrente,10,85,6,45,4,40,11,17,2010
505,N.Y. Giants,Washington,1/2/2011,Scott Green,6,49,2,24,4,25,7,17,2010
506,Minnesota,Detroit,1/2/2011,Walt Anderson,8,58,3,25,5,33,12,17,2010
507,Chicago,Green Bay,1/2/2011,Al Riveron,10,76,6,46,4,30,10,17,2010
508,Carolina,Atlanta,1/2/2011,John Parry,14,117,10,97,4,20,14,17,2010
509,Tampa Bay,New Orleans,1/2/2011,Gene Steratore,12,99,7,54,5,45,14,17,2010
510,San Diego,Denver,1/2/2011,Walt Coleman,8,77,3,32,5,45,12,17,2010
511,Arizona,San Francisco,1/2/2011,Mike Carey,13,68,8,43,5,25,16,17,2010
512,St. Louis,Seattle,1/2/2011,Jerome Boger,13,116,6,46,7,70,13,17,2010
513,New Orleans,Green Bay,9/8/2011,Clete Blakeman,9,63,3,15,6,48,11,1,2011
514,Pittsburgh,Baltimore,9/11/2011,Tony Corrente,13,128,6,53,7,75,13,1,2011
515,Cincinnati,Cleveland,9/11/2011,Bill Leavy,14,94,3,22,11,72,18,1,2011
516,Indianapolis,Houston,9/11/2011,Walt Coleman,10,90,6,60,4,30,11,1,2011
517,Tennessee,Jacksonville,9/11/2011,Mike Carey,12,99,7,60,5,39,17,1,2011
518,Buffalo,Kansas City,9/11/2011,Scott Green,6,33,5,30,1,3,9,1,2011
519,Atlanta,Chicago,9/11/2011,Ed Hochuli,17,121,9,65,8,56,18,1,2011
520,Detroit,Tampa Bay,9/11/2011,Walt Anderson,14,107,8,68,6,39,16,1,2011
521,Philadelphia,St. Louis,9/11/2011,Gene Steratore,17,151,8,91,9,60,21,1,2011
522,N.Y. Giants,Washington,9/11/2011,Ron Winter,11,88,8,63,3,25,11,1,2011
523,Carolina,Arizona,9/11/2011,Carl Cheffers,16,135,10,74,6,61,18,1,2011
524,Seattle,San Francisco,9/11/2011,Jeff Triplette,20,174,11,72,9,102,27,1,2011
525,Minnesota,San Diego,9/11/2011,Terry McAulay,13,104,9,78,4,26,14,1,2011
526,Dallas,N.Y. Jets,9/11/2011,Al Riveron,7,40,7,40,0,0,7,1,2011
527,New England,Miami,9/12/2011,Pete Morelli,15,110,7,50,8,60,19,1,2011
528,Oakland,Denver,9/12/2011,Jerome Boger,25,222,15,131,10,91,29,1,2011
529,Kansas City,Detroit,9/18/2011,Tony Corrente,12,105,8,70,4,35,15,2,2011
530,Oakland,Buffalo,9/18/2011,Mike Carey,11,111,8,85,3,26,12,2,2011
531,Baltimore,Tennessee,9/18/2011,Clete Blakeman,13,114,7,44,6,70,13,2,2011
532,Jacksonville,N.Y. Jets,9/18/2011,Scott Green,11,110,4,50,7,60,12,2,2011
533,Cleveland,Indianapolis,9/18/2011,Gene Steratore,7,70,3,49,4,21,9,2,2011
534,Arizona,Washington,9/18/2011,Pete Morelli,13,112,10,97,3,15,16,2,2011
535,Tampa Bay,Minnesota,9/18/2011,Jeff Triplette,14,118,6,53,8,65,16,2,2011
536,Green Bay,Carolina,9/18/2011,Al Riveron,13,107,7,57,6,50,15,2,2011
537,Chicago,New Orleans,9/18/2011,Walt Coleman,13,88,6,47,7,41,14,2,2011
538,Seattle,Pittsburgh,9/18/2011,Bill Leavy,10,114,6,66,4,48,12,2,2011
539,Dallas,San Francisco,9/18/2011,Ron Winter,13,108,8,83,5,25,13,2,2011
540,San Diego,New England,9/18/2011,Walt Anderson,14,124,6,44,8,80,17,2,2011
541,Cincinnati,Denver,9/18/2011,Ed Hochuli,14,124,7,69,7,55,15,2,2011
542,Houston,Miami,9/18/2011,John Parry,7,96,4,76,3,20,10,2,2011
543,Philadelphia,Atlanta,9/18/2011,Carl Cheffers,11,77,4,20,7,57,17,2,2011
544,St. Louis,N.Y. Giants,9/19/2011,Terry McAulay,13,140,8,85,5,55,14,2,2011
545,Jacksonville,Carolina,9/25/2011,Bill Leavy,16,129,8,60,8,69,16,3,2011
546,Houston,New Orleans,9/25/2011,Tony Corrente,11,82,7,56,4,26,13,3,2011
547,New England,Buffalo,9/25/2011,Carl Cheffers,17,170,8,93,9,77,19,3,2011
548,Miami,Cleveland,9/25/2011,Walt Anderson,18,178,10,93,8,85,18,3,2011
549,Denver,Tennessee,9/25/2011,John Parry,12,95,1,15,11,80,12,3,2011
550,N.Y. Giants,Philadelphia,9/25/2011,Jeff Triplette,11,57,4,21,7,36,12,3,2011
551,Detroit,Minnesota,9/25/2011,Ron Winter,17,144,7,65,10,79,23,3,2011
552,San Francisco,Cincinnati,9/25/2011,Jerome Boger,18,110,12,70,6,40,20,3,2011
553,N.Y. Jets,Oakland,9/25/2011,Gene Steratore,14,116,7,61,7,55,16,3,2011
554,Kansas City,San Diego,9/25/2011,Walt Coleman,11,105,7,65,4,40,12,3,2011
555,Baltimore,St. Louis,9/25/2011,Scott Green,12,134,5,32,7,102,13,3,2011
556,Green Bay,Chicago,9/25/2011,Mike Carey,17,105,7,35,10,70,24,3,2011
557,Arizona,Seattle,9/25/2011,Al Riveron,10,59,2,20,8,39,13,3,2011
558,Atlanta,Tampa Bay,9/25/2011,Clete Blakeman,16,116,7,50,9,66,20,3,2011
559,Pittsburgh,Indianapolis,9/25/2011,Terry McAulay,7,59,4,38,3,21,8,3,2011
560,Washington,Dallas,9/26/2011,Ed Hochuli,10,90,4,35,6,55,10,3,2011
561,Buffalo,Cincinnati,10/2/2011,Gene Steratore,7,41,4,26,3,15,9,4,2011
562,Tennessee,Cleveland,10/2/2011,Pete Morelli,10,85,5,45,5,40,12,4,2011
563,Pittsburgh,Houston,10/2/2011,Clete Blakeman,14,109,5,45,9,64,15,4,2011
564,Detroit,Dallas,10/2/2011,John Parry,17,108,10,75,7,33,21,4,2011
565,San Francisco,Philadelphia,10/2/2011,Al Riveron,10,95,5,40,5,55,12,4,2011
566,Carolina,Chicago,10/2/2011,Terry McAulay,13,97,8,52,5,45,13,4,2011
567,Washington,St. Louis,10/2/2011,Walt Coleman,19,161,10,96,9,65,21,4,2011
568,New Orleans,Jacksonville,10/2/2011,Ed Hochuli,8,65,6,50,2,15,9,4,2011
569,Minnesota,Kansas City,10/2/2011,Bill Leavy,12,102,6,45,6,57,16,4,2011
570,N.Y. Giants,Arizona,10/2/2011,Jerome Boger,18,173,8,70,10,103,22,4,2011
571,Atlanta,Seattle,10/2/2011,Walt Anderson,10,75,5,50,5,25,12,4,2011
572,Denver,Green Bay,10/2/2011,Scott Green,6,51,3,24,3,27,7,4,2011
573,New England,Oakland,10/2/2011,Tony Corrente,14,130,5,45,9,85,16,4,2011
574,Miami,San Diego,10/2/2011,Jeff Triplette,10,121,2,41,8,80,10,4,2011
575,N.Y. Jets,Baltimore,10/2/2011,Mike Carey,16,115,9,69,7,46,16,4,2011
576,Indianapolis,Tampa Bay,10/3/2011,Ron Winter,20,156,6,50,14,106,22,4,2011
577,Tennessee,Pittsburgh,10/9/2011,Walt Anderson,14,121,10,85,4,36,15,5,2011
578,Oakland,Houston,10/9/2011,Pete Morelli,17,139,11,89,6,50,18,5,2011
579,Kansas City,Indianapolis,10/9/2011,Carl Cheffers,9,79,5,39,4,40,15,5,2011
580,Cincinnati,Jacksonville,10/9/2011,Al Riveron,6,48,4,33,2,15,10,5,2011
581,Seattle,N.Y. Giants,10/9/2011,Ed Hochuli,17,122,10,70,7,52,20,5,2011
582,Arizona,Minnesota,10/9/2011,Scott Green,11,99,6,64,5,35,12,5,2011
583,New Orleans,Carolina,10/9/2011,John Parry,16,147,9,82,7,65,16,5,2011
584,Philadelphia,Buffalo,10/9/2011,Walt Coleman,9,86,5,46,4,40,10,5,2011
585,Tampa Bay,San Francisco,10/9/2011,Terry McAulay,12,126,9,96,3,30,14,5,2011
586,N.Y. Jets,New England,10/9/2011,Jerome Boger,14,139,8,89,6,50,14,5,2011
587,San Diego,Denver,10/9/2011,Gene Steratore,4,53,0,0,4,53,7,5,2011
588,Green Bay,Atlanta,10/9/2011,Jeff Triplette,11,99,6,55,5,44,12,5,2011
589,Chicago,Detroit,10/10/2011,Clete Blakeman,26,198,14,104,12,94,26,5,2011
590,Buffalo,N.Y. Giants,10/16/2011,Clete Blakeman,14,154,8,91,6,63,17,6,2011
591,Indianapolis,Cincinnati,10/16/2011,John Parry,13,122,2,11,11,111,15,6,2011
592,Jacksonville,Pittsburgh,10/16/2011,Ron Winter,12,87,4,22,8,65,14,6,2011
593,Philadelphia,Washington,10/16/2011,Bill Leavy,17,135,8,60,9,75,18,6,2011
594,San Francisco,Detroit,10/16/2011,Mike Carey,21,174,15,120,6,54,23,6,2011
595,St. Louis,Green Bay,10/16/2011,Ed Hochuli,10,61,7,45,3,16,12,6,2011
596,Carolina,Atlanta,10/16/2011,Pete Morelli,11,142,7,85,4,57,16,6,2011
597,Cleveland,Oakland,10/16/2011,Carl Cheffers,10,69,5,34,5,35,11,6,2011
598,Houston,Baltimore,10/16/2011,Gene Steratore,10,40,5,15,5,25,12,6,2011
599,New Orleans,Tampa Bay,10/16/2011,Jerome Boger,14,117,7,53,7,64,17,6,2011
600,Dallas,New England,10/16/2011,Walt Coleman,15,112,10,77,5,35,20,6,2011
601,Minnesota,Chicago,10/16/2011,Walt Anderson,8,55,5,40,3,15,9,6,2011
602,Miami,N.Y. Jets,10/17/2011,Tony Corrente,8,59,2,10,6,49,10,6,2011
603,Denver,Miami,10/23/2011,Clete Blakeman,7,50,5,30,2,20,8,7,2011
604,San Diego,N.Y. Jets,10/23/2011,Ron Winter,21,155,13,95,8,60,22,7,2011
605,Houston,Tennessee,10/23/2011,Terry McAulay,14,144,6,68,8,76,15,7,2011
606,Atlanta,Detroit,10/23/2011,Bill Leavy,21,164,11,80,10,84,25,7,2011
607,Washington,Carolina,10/23/2011,Jerome Boger,16,131,3,26,13,105,18,7,2011
608,Chicago,Tampa Bay,10/23/2011,Tony Corrente,15,123,7,54,8,69,17,7,2011
609,Seattle,Cleveland,10/23/2011,Mike Carey,15,116,8,68,7,48,16,7,2011
610,Pittsburgh,Arizona,10/23/2011,John Parry,18,136,9,69,9,67,20,7,2011
611,Kansas City,Oakland,10/23/2011,Jeff Triplette,24,218,10,98,14,120,26,7,2011
612,Green Bay,Minnesota,10/23/2011,Pete Morelli,15,135,6,44,9,91,15,7,2011
613,St. Louis,Dallas,10/23/2011,Al Riveron,10,46,4,16,6,30,10,7,2011
614,Indianapolis,New Orleans,10/23/2011,Scott Green,8,59,7,49,1,10,9,7,2011
615,Baltimore,Jacksonville,10/24/2011,Carl Cheffers,16,175,10,85,6,90,20,7,2011
616,Miami,N.Y. Giants,10/30/2011,Ron Winter,11,76,4,30,7,46,12,8,2011
617,Jacksonville,Houston,10/30/2011,Scott Green,12,99,5,39,7,60,13,8,2011
618,Indianapolis,Tennessee,10/30/2011,Jerome Boger,13,106,10,66,3,40,15,8,2011
619,Minnesota,Carolina,10/30/2011,Ed Hochuli,10,103,4,43,6,60,10,8,2011
620,New Orleans,St. Louis,10/30/2011,Walt Anderson,14,96,5,32,9,64,15,8,2011
621,Arizona,Baltimore,10/30/2011,Jeff Triplette,23,191,12,92,11,99,25,8,2011
622,Detroit,Denver,10/30/2011,Walt Coleman,9,100,4,45,5,55,17,8,2011
623,Washington,Buffalo,10/30/2011,Terry McAulay,9,89,3,54,6,35,9,8,2011
624,New England,Pittsburgh,10/30/2011,Mike Carey,14,87,6,37,8,50,18,8,2011
625,Cleveland,San Francisco,10/30/2011,Bill Leavy,10,79,5,39,5,40,12,8,2011
626,Cincinnati,Seattle,10/30/2011,Tony Corrente,18,145,7,65,11,80,18,8,2011
627,Dallas,Philadelphia,10/30/2011,Gene Steratore,9,53,3,20,6,33,9,8,2011
628,San Diego,Kansas City,10/31/2011,Al Riveron,21,158,12,105,9,53,22,8,2011
629,N.Y. Jets,Buffalo,11/6/2011,Ed Hochuli,15,144,9,60,6,84,15,9,2011
630,Cleveland,Houston,11/6/2011,Al Riveron,6,50,4,35,2,15,9,9,2011
631,Miami,Kansas City,11/6/2011,Walt Anderson,15,119,7,49,8,70,16,9,2011
632,Seattle,Dallas,11/6/2011,Terry McAulay,17,170,10,88,7,82,17,9,2011
633,San Francisco,Washington,11/6/2011,Gene Steratore,12,90,9,55,3,35,15,9,2011
634,Tampa Bay,New Orleans,11/6/2011,Carl Cheffers,17,143,9,80,8,63,17,9,2011
635,Atlanta,Indianapolis,11/6/2011,Mike Carey,7,42,1,10,6,32,8,9,2011
636,Denver,Oakland,11/6/2011,John Parry,26,223,11,93,15,130,30,9,2011
637,Cincinnati,Tennessee,11/6/2011,Jeff Triplette,16,187,9,87,7,100,18,9,2011
638,N.Y. Giants,New England,11/6/2011,Pete Morelli,13,131,6,50,7,81,13,9,2011
639,Green Bay,San Diego,11/6/2011,Clete Blakeman,13,97,5,33,8,64,14,9,2011
640,St. Louis,Arizona,11/6/2011,Ron Winter,15,116,9,71,6,45,16,9,2011
641,Baltimore,Pittsburgh,11/6/2011,Walt Coleman,9,89,3,20,6,69,11,9,2011
642,Chicago,Philadelphia,11/7/2011,Scott Green,12,97,6,53,6,44,12,9,2011
643,Oakland,San Diego,11/10/2011,Ed Hochuli,13,76,7,45,6,31,14,10,2011
644,Buffalo,Dallas,11/13/2011,Jerome Boger,11,86,3,12,8,74,11,10,2011
645,Tennessee,Carolina,11/13/2011,Walt Coleman,21,191,9,92,12,99,26,10,2011
646,Houston,Tampa Bay,11/13/2011,John Parry,14,103,8,54,6,49,15,10,2011
647,Pittsburgh,Cincinnati,11/13/2011,Bill Leavy,8,66,4,31,4,35,13,10,2011
648,Jacksonville,Indianapolis,11/13/2011,Jeff Triplette,11,95,5,55,6,40,12,10,2011
649,Denver,Kansas City,11/13/2011,Ron Winter,12,105,8,65,4,40,13,10,2011
650,Arizona,Philadelphia,11/13/2011,Walt Anderson,18,163,7,66,11,97,19,10,2011
651,Detroit,Chicago,11/13/2011,Pete Morelli,8,90,4,53,4,37,11,10,2011
652,New Orleans,Atlanta,11/13/2011,Terry McAulay,18,164,8,79,10,85,20,10,2011
653,Washington,Miami,11/13/2011,Carl Cheffers,12,106,6,51,6,55,15,10,2011
654,St. Louis,Cleveland,11/13/2011,Clete Blakeman,13,115,7,55,6,60,16,10,2011
655,Baltimore,Seattle,11/13/2011,Scott Green,17,134,4,34,13,100,21,10,2011
656,N.Y. Giants,San Francisco,11/13/2011,Tony Corrente,11,80,6,45,5,35,13,10,2011
657,New England,N.Y. Jets,11/13/2011,Gene Steratore,14,136,9,80,5,56,17,10,2011
658,Minnesota,Green Bay,11/14/2011,Mike Carey,11,85,10,80,1,5,12,10,2011
659,N.Y. Jets,Denver,11/17/2011,Bill Leavy,8,66,2,15,6,51,8,11,2011
660,Oakland,Minnesota,11/20/2011,Jerome Boger,21,167,12,117,9,50,25,11,2011
661,Tennessee,Atlanta,11/20/2011,John Parry,15,141,10,86,5,55,17,11,2011
662,Buffalo,Miami,11/20/2011,Walt Coleman,7,77,3,27,4,50,9,11,2011
663,Jacksonville,Cleveland,11/20/2011,Terry McAulay,18,151,9,81,9,70,20,11,2011
664,Cincinnati,Baltimore,11/20/2011,Ron Winter,12,112,6,43,6,69,13,11,2011
665,Dallas,Washington,11/20/2011,Ed Hochuli,15,107,9,48,6,59,15,11,2011
666,Carolina,Detroit,11/20/2011,Gene Steratore,15,126,7,70,8,56,18,11,2011
667,Tampa Bay,Green Bay,11/20/2011,Al Riveron,14,92,9,55,5,37,19,11,2011
668,Arizona,San Francisco,11/20/2011,Pete Morelli,13,162,6,75,7,87,13,11,2011
669,Seattle,St. Louis,11/20/2011,Carl Cheffers,18,150,13,100,5,50,22,11,2011
670,San Diego,Chicago,11/20/2011,Jeff Triplette,9,81,3,20,6,61,11,11,2011
671,Philadelphia,N.Y. Giants,11/20/2011,Mike Carey,10,69,5,30,5,39,16,11,2011
672,Kansas City,New England,11/21/2011,Clete Blakeman,8,54,5,34,3,20,12,11,2011
673,Green Bay,Detroit,11/24/2011,Terry McAulay,18,136,7,54,11,82,21,12,2011
674,Miami,Dallas,11/24/2011,Pete Morelli,17,124,6,55,11,69,19,12,2011
675,San Francisco,Baltimore,11/24/2011,John Parry,10,117,7,97,3,20,10,12,2011
676,Buffalo,N.Y. Jets,11/27/2011,Carl Cheffers,13,125,9,85,4,40,16,12,2011
677,Cleveland,Cincinnati,11/27/2011,Walt Anderson,8,50,3,15,5,35,11,12,2011
678,Houston,Jacksonville,11/27/2011,Walt Coleman,11,110,7,80,4,30,15,12,2011
679,Minnesota,Atlanta,11/27/2011,Al Riveron,10,79,6,49,4,30,13,12,2011
680,Arizona,St. Louis,11/27/2011,Mike Carey,12,79,4,30,8,49,13,12,2011
681,Carolina,Indianapolis,11/27/2011,Tony Corrente,8,107,6,92,2,15,8,12,2011
682,Tampa Bay,Tennessee,11/27/2011,Bill Leavy,9,80,4,30,5,50,11,12,2011
683,Washington,Seattle,11/27/2011,Clete Blakeman,19,206,10,115,9,91,23,12,2011
684,Chicago,Oakland,11/27/2011,Ron Winter,13,105,7,61,6,44,15,12,2011
685,New England,Philadelphia,11/27/2011,Jerome Boger,13,80,3,20,10,60,18,12,2011
686,Denver,San Diego,11/27/2011,Jeff Triplette,13,93,9,63,4,30,15,12,2011
687,Pittsburgh,Kansas City,11/27/2011,Ed Hochuli,10,70,6,50,4,20,17,12,2011
688,N.Y. Giants,New Orleans,11/28/2011,Gene Steratore,15,136,4,32,11,104,16,12,2011
689,Philadelphia,Seattle,12/1/2011,Pete Morelli,10,58,5,28,5,30,13,13,2011
690,N.Y. Jets,Washington,12/4/2011,John Parry,12,90,6,40,6,50,15,13,2011
691,Kansas City,Chicago,12/4/2011,Jerome Boger,13,95,8,60,5,35,15,13,2011
692,Tennessee,Buffalo,12/4/2011,Al Riveron,5,35,3,20,2,15,9,13,2011
693,Oakland,Miami,12/4/2011,Mike Carey,18,170,10,91,8,79,18,13,2011
694,Baltimore,Cleveland,12/4/2011,Ed Hochuli,7,55,4,18,3,37,8,13,2011
695,Cincinnati,Pittsburgh,12/4/2011,Carl Cheffers,14,138,10,109,4,29,18,13,2011
696,Detroit,New Orleans,12/4/2011,Clete Blakeman,14,137,11,107,3,30,16,13,2011
697,Carolina,Tampa Bay,12/4/2011,Gene Steratore,11,93,2,20,9,73,13,13,2011
698,Atlanta,Houston,12/4/2011,Bill Leavy,12,78,7,43,5,35,17,13,2011
699,Denver,Minnesota,12/4/2011,Terry McAulay,14,127,8,73,6,54,15,13,2011
700,Green Bay,N.Y. Giants,12/4/2011,Jeff Triplette,10,85,4,30,6,55,10,13,2011
701,Dallas,Arizona,12/4/2011,Walt Coleman,13,90,7,49,6,41,15,13,2011
702,St. Louis,San Francisco,12/4/2011,Pete Morelli,13,107,5,35,8,72,17,13,2011
703,Indianapolis,New England,12/4/2011,Ron Winter,8,49,5,29,3,20,8,13,2011
704,San Diego,Jacksonville,12/5/2011,Walt Anderson,9,81,6,55,3,26,12,13,2011
705,Cleveland,Pittsburgh,12/8/2011,Ed Hochuli,18,151,6,54,12,97,20,14,2011
706,New England,Washington,12/11/2011,Jeff Triplette,12,120,5,57,7,63,15,14,2011
707,Oakland,Green Bay,12/11/2011,Pete Morelli,16,124,11,89,5,35,18,14,2011
708,Kansas City,N.Y. Jets,12/11/2011,Terry McAulay,15,150,11,128,4,22,16,14,2011
709,Houston,Cincinnati,12/11/2011,Ed Hochuli,8,77,5,50,3,27,9,14,2011
710,Indianapolis,Baltimore,12/11/2011,Clete Blakeman,8,55,3,15,5,40,9,14,2011
711,Minnesota,Detroit,12/11/2011,John Parry,14,108,4,32,10,76,14,14,2011
712,Atlanta,Carolina,12/11/2011,Walt Anderson,10,100,5,50,5,50,11,14,2011
713,Philadelphia,Miami,12/11/2011,Ron Winter,14,150,7,69,7,81,17,14,2011
714,Tampa Bay,Jacksonville,12/11/2011,Jerome Boger,20,177,12,97,8,80,22,14,2011
715,New Orleans,Tennessee,12/11/2011,Mike Carey,19,149,11,95,8,54,22,14,2011
716,San Francisco,Arizona,12/11/2011,Al Riveron,9,80,5,35,4,45,10,14,2011
717,Chicago,Denver,12/11/2011,Carl Cheffers,12,97,8,69,4,28,14,14,2011
718,Buffalo,San Diego,12/11/2011,Gene Steratore,6,55,1,5,5,50,7,14,2011
719,N.Y. Giants,Dallas,12/11/2011,Scott Green,16,106,6,55,10,51,18,14,2011
720,St. Louis,Seattle,12/12/2011,Bill Leavy,14,91,5,30,9,61,14,14,2011
721,Jacksonville,Atlanta,12/15/2011,Ron Winter,9,71,5,40,4,31,9,15,2011
722,Dallas,Tampa Bay,12/17/2011,Terry McAulay,8,61,2,15,6,46,9,15,2011
723,Cincinnati,St. Louis,12/18/2011,Jerome Boger,21,210,11,101,10,109,22,15,2011
724,Miami,Buffalo,12/18/2011,John Parry,16,154,5,62,11,92,21,15,2011
725,Tennessee,Indianapolis,12/18/2011,Pete Morelli,11,95,7,70,4,25,11,15,2011
726,Washington,N.Y. Giants,12/18/2011,Al Riveron,10,123,2,48,8,75,11,15,2011
727,Seattle,Chicago,12/18/2011,Ed Hochuli,10,76,5,31,5,45,12,15,2011
728,New Orleans,Minnesota,12/18/2011,Walt Anderson,14,149,6,65,8,84,18,15,2011
729,Carolina,Houston,12/18/2011,Jeff Triplette,13,100,7,40,6,60,13,15,2011
730,Green Bay,Kansas City,12/18/2011,Gene Steratore,12,90,5,35,7,55,14,15,2011
731,Detroit,Oakland,12/18/2011,Bill Leavy,19,158,9,72,10,86,19,15,2011
732,N.Y. Jets,Philadelphia,12/18/2011,Clete Blakeman,18,155,11,93,7,62,18,15,2011
733,Cleveland,Arizona,12/18/2011,Scott Green,11,87,9,74,2,13,12,15,2011
734,New England,Denver,12/18/2011,Mike Carey,11,69,4,30,7,39,14,15,2011
735,Baltimore,San Diego,12/18/2011,Carl Cheffers,6,60,3,25,3,35,7,15,2011
736,Pittsburgh,San Francisco,12/19/2011,Walt Coleman,16,121,9,72,7,49,18,15,2011
737,Houston,Indianapolis,12/22/2011,Jerome Boger,15,119,11,84,4,35,18,16,2011
738,Denver,Buffalo,12/24/2011,Walt Anderson,15,127,7,58,8,69,15,16,2011
739,Miami,New England,12/24/2011,Al Riveron,11,89,6,39,5,50,11,16,2011
740,Cleveland,Baltimore,12/24/2011,Walt Coleman,11,146,6,95,5,51,11,16,2011
741,Jacksonville,Tennessee,12/24/2011,Gene Steratore,6,28,6,28,0,0,6,16,2011
742,Oakland,Kansas City,12/24/2011,Mike Carey,26,180,15,92,11,88,30,16,2011
743,N.Y. Giants,N.Y. Jets,12/24/2011,Pete Morelli,15,140,5,45,10,95,15,16,2011
744,Minnesota,Washington,12/24/2011,Tony Corrente,12,104,4,40,8,64,16,16,2011
745,Tampa Bay,Carolina,12/24/2011,Carl Cheffers,15,141,7,64,8,77,17,16,2011
746,Arizona,Cincinnati,12/24/2011,Terry McAulay,12,134,6,87,6,47,17,16,2011
747,St. Louis,Pittsburgh,12/24/2011,Clete Blakeman,11,71,4,21,7,50,14,16,2011
748,San Diego,Detroit,12/24/2011,Ed Hochuli,4,18,1,10,3,8,5,16,2011
749,Philadelphia,Dallas,12/24/2011,Bill Leavy,11,94,5,47,6,47,12,16,2011
750,San Francisco,Seattle,12/24/2011,Ron Winter,12,128,6,77,6,51,14,16,2011
751,Chicago,Green Bay,12/25/2011,John Parry,6,28,6,28,0,0,9,16,2011
752,Atlanta,New Orleans,12/26/2011,Jeff Triplette,11,103,7,57,4,46,12,16,2011
753,N.Y. Jets,Miami,1/1/2012,Jerome Boger,11,75,6,40,5,35,11,17,2011
754,Buffalo,New England,1/1/2012,Bill Leavy,9,122,5,45,4,77,13,17,2011
755,Baltimore,Cincinnati,1/1/2012,Tony Corrente,11,94,7,59,4,35,13,17,2011
756,Pittsburgh,Cleveland,1/1/2012,Al Riveron,9,77,4,37,5,40,11,17,2011
757,Tennessee,Houston,1/1/2012,Ron Winter,13,102,6,47,7,55,17,17,2011
758,Indianapolis,Jacksonville,1/1/2012,John Parry,5,50,4,40,1,10,6,17,2011
759,Dallas,N.Y. Giants,1/1/2012,Walt Anderson,10,71,7,43,3,28,10,17,2011
760,Washington,Philadelphia,1/1/2012,Carl Cheffers,14,146,6,71,8,75,16,17,2011
761,Detroit,Green Bay,1/1/2012,Walt Coleman,17,179,11,101,6,78,22,17,2011
762,Chicago,Minnesota,1/1/2012,Mike Carey,9,58,4,20,5,38,11,17,2011
763,Tampa Bay,Atlanta,1/1/2012,Scott Green,5,40,2,20,3,20,9,17,2011
764,Carolina,New Orleans,1/1/2012,Ed Hochuli,7,65,1,5,6,60,7,17,2011
765,San Francisco,St. Louis,1/1/2012,Jeff Triplette,11,130,5,80,6,50,14,17,2011
766,Kansas City,Denver,1/1/2012,Pete Morelli,12,85,6,36,6,49,14,17,2011
767,San Diego,Oakland,1/1/2012,Clete Blakeman,16,132,8,68,8,64,18,17,2011
768,Seattle,Arizona,1/1/2012,Gene Steratore,16,131,7,55,9,76,18,17,2011
769,Dallas,N.Y. Giants,9/5/2012,Jim Core,17,119,13,86,4,33,19,1,2012
770,Indianapolis,Chicago,9/9/2012,Wayne Elliott,10,67,3,19,7,48,12,1,2012
771,Jacksonville,Minnesota,9/9/2012,Robert Dalton,9,65,4,25,5,40,10,1,2012
772,Buffalo,N.Y. Jets,9/9/2012,Robert Frazer,11,68,6,34,5,34,13,1,2012
773,Miami,Houston,9/9/2012,Don King,11,113,7,78,4,35,11,1,2012
774,New England,Tennessee,9/9/2012,Jerry Frump,6,50,3,20,3,30,7,1,2012
775,St. Louis,Detroit,9/9/2012,Donovan Briggans,10,92,7,65,3,27,10,1,2012
776,Washington,New Orleans,9/9/2012,David Scott,24,234,12,127,12,107,25,1,2012
777,Philadelphia,Cleveland,9/9/2012,Kent Roan,15,145,12,110,3,35,19,1,2012
778,Atlanta,Kansas City,9/9/2012,Mike Shepherd,4,37,2,12,2,25,6,1,2012
779,San Francisco,Green Bay,9/9/2012,David White,18,143,8,66,10,77,18,1,2012
780,Seattle,Arizona,9/9/2012,Bruce Hermansen,23,192,13,90,10,102,26,1,2012
781,Carolina,Tampa Bay,9/9/2012,Jerry Hughes,10,100,6,65,4,35,10,1,2012
782,Pittsburgh,Denver,9/9/2012,Gerald Wright,14,101,8,52,6,49,17,1,2012
783,Cincinnati,Baltimore,9/10/2012,"Richard ""Matt"" Nicks",9,91,3,41,6,50,9,1,2012
784,San Diego,Oakland,9/10/2012,Jim Core,15,113,9,78,6,35,15,1,2012
785,Chicago,Green Bay,9/13/2012,Gerald Wright,12,119,8,65,4,54,12,2,2012
786,Tampa Bay,N.Y. Giants,9/16/2012,Jim Core,12,86,5,33,7,53,15,2,2012
787,New Orleans,Carolina,9/16/2012,Gerald Wright,6,57,2,23,4,34,6,2,2012
788,Arizona,New England,9/16/2012,David Scott,13,99,5,39,8,60,14,2,2012
789,Minnesota,Indianapolis,9/16/2012,Don King,18,156,11,105,7,51,19,2,2012
790,Baltimore,Philadelphia,9/16/2012,Robert Frazer,13,103,6,45,7,58,18,2,2012
791,Kansas City,Buffalo,9/16/2012,Robert Dalton,9,83,4,33,5,50,13,2,2012
792,Cleveland,Cincinnati,9/16/2012,Jerry Hughes,16,157,10,103,6,54,18,2,2012
793,Houston,Jacksonville,9/16/2012,David White,18,135,10,64,8,71,18,2,2012
794,Dallas,Seattle,9/16/2012,Donovan Briggans,10,82,5,47,5,35,11,2,2012
795,Washington,St. Louis,9/16/2012,Wayne Elliott,18,156,11,96,7,60,19,2,2012
796,N.Y. Jets,Pittsburgh,9/16/2012,Jerry Frump,17,170,7,63,10,107,19,2,2012
797,Tennessee,San Diego,9/16/2012,Bruce Hermansen,12,100,8,59,4,41,15,2,2012
798,Oakland,Miami,9/16/2012,Mike Shepherd,8,63,5,42,3,21,11,2,2012
799,Detroit,San Francisco,9/16/2012,"Richard ""Matt"" Nicks",13,129,8,67,5,62,13,2,2012
800,Denver,Atlanta,9/17/2012,Kent Roan,18,168,10,96,8,72,20,2,2012
801,N.Y. Giants,Carolina,9/20/2012,Robert Frazer,8,60,5,38,3,22,10,3,2012
802,Tampa Bay,Dallas,9/23/2012,Robert Dalton,23,174,10,69,13,105,26,3,2012
803,St. Louis,Chicago,9/23/2012,Jerry Hughes,10,85,4,40,6,45,13,3,2012
804,San Francisco,Minnesota,9/23/2012,Kent Roan,7,70,6,60,1,10,7,3,2012
805,Detroit,Tennessee,9/23/2012,Gerald Wright,16,123,10,91,6,32,20,3,2012
806,Cincinnati,Washington,9/23/2012,"Richard ""Matt"" Nicks",14,140,8,80,6,60,16,3,2012
807,Kansas City,New Orleans,9/23/2012,Don King,10,85,6,40,4,45,11,3,2012
808,N.Y. Jets,Miami,9/23/2012,Robert Frazer,20,173,9,108,11,65,22,3,2012
809,Buffalo,Cleveland,9/23/2012,David Scott,16,132,10,75,6,57,17,3,2012
810,Jacksonville,Indianapolis,9/23/2012,Donovan Briggans,17,173,5,52,12,121,21,3,2012
811,Philadelphia,Arizona,9/23/2012,Mike Shepherd,10,110,5,65,5,45,11,3,2012
812,Atlanta,San Diego,9/23/2012,Jim Core,6,32,2,15,4,17,6,3,2012
813,Houston,Denver,9/23/2012,Jerry Frump,16,144,9,69,7,75,17,3,2012
814,Pittsburgh,Oakland,9/23/2012,David White,13,106,10,81,3,25,14,3,2012
815,New England,Baltimore,9/23/2012,Bruce Hermansen,24,218,10,83,14,135,25,3,2012
816,Green Bay,Seattle,9/24/2012,Wayne Elliott,24,245,10,127,14,118,28,3,2012
817,Cleveland,Baltimore,9/27/2012,Gene Steratore,18,166,7,66,11,100,21,4,2012
818,New England,Buffalo,9/30/2012,John Parry,4,27,1,10,3,17,7,4,2012
819,Tennessee,Houston,9/30/2012,Carl Cheffers,8,76,7,73,1,3,12,4,2012
820,San Diego,Kansas City,9/30/2012,Bill Leavy,16,155,7,75,9,80,18,4,2012
821,Minnesota,Detroit,9/30/2012,Clete Blakeman,10,159,5,87,5,72,11,4,2012
822,Carolina,Atlanta,9/30/2012,Walt Coleman,11,79,9,64,2,15,15,4,2012
823,Seattle,St. Louis,9/30/2012,Mike Carey,11,92,5,55,6,37,15,4,2012
824,San Francisco,N.Y. Jets,9/30/2012,Tony Corrente,12,97,8,67,4,30,12,4,2012
825,Miami,Arizona,9/30/2012,Scott Green,10,102,4,40,6,62,12,4,2012
826,Oakland,Denver,9/30/2012,Pete Morelli,9,71,5,41,4,30,9,4,2012
827,Cincinnati,Jacksonville,9/30/2012,Ed Hochuli,9,87,6,50,3,37,9,4,2012
828,New Orleans,Green Bay,9/30/2012,Jeff Triplette,17,115,10,72,7,43,19,4,2012
829,Washington,Tampa Bay,9/30/2012,Al Riveron,18,180,8,73,10,107,19,4,2012
830,N.Y. Giants,Philadelphia,9/30/2012,Ron Winter,12,104,7,55,5,49,13,4,2012
831,Chicago,Dallas,10/1/2012,Walt Anderson,6,35,4,25,2,10,6,4,2012
832,Arizona,St. Louis,10/4/2012,John Parry,12,95,5,35,7,60,14,5,2012
833,Atlanta,Washington,10/7/2012,Bill Leavy,6,33,2,13,4,20,9,5,2012
834,Philadelphia,Pittsburgh,10/7/2012,Tony Corrente,14,141,5,35,9,106,17,5,2012
835,Green Bay,Indianapolis,10/7/2012,Walt Anderson,18,189,9,89,9,100,25,5,2012
836,Cleveland,N.Y. Giants,10/7/2012,Clete Blakeman,13,116,10,91,3,25,16,5,2012
837,Tennessee,Minnesota,10/7/2012,Jeff Triplette,15,135,10,75,5,60,16,5,2012
838,Miami,Cincinnati,10/7/2012,Walt Coleman,7,56,2,10,5,46,9,5,2012
839,Baltimore,Kansas City,10/7/2012,Pete Morelli,13,93,5,33,8,60,16,5,2012
840,Seattle,Carolina,10/7/2012,Terry McAulay,10,90,7,65,3,25,11,5,2012
841,Chicago,Jacksonville,10/7/2012,Ron Winter,18,129,12,80,6,49,18,5,2012
842,Denver,New England,10/7/2012,Gene Steratore,10,80,4,21,6,59,12,5,2012
843,Buffalo,San Francisco,10/7/2012,Jerome Boger,12,83,5,30,7,53,14,5,2012
844,San Diego,New Orleans,10/7/2012,Carl Cheffers,17,155,7,56,10,99,19,5,2012
845,Houston,N.Y. Jets,10/8/2012,Scott Green,12,75,7,50,5,25,14,5,2012
846,Pittsburgh,Tennessee,10/11/2012,Ed Hochuli,9,95,4,50,5,45,13,6,2012
847,Oakland,Atlanta,10/14/2012,Terry McAulay,14,135,12,110,2,25,17,6,2012
848,Kansas City,Tampa Bay,10/14/2012,Walt Coleman,13,88,7,55,6,33,15,6,2012
849,Indianapolis,N.Y. Jets,10/14/2012,Bill Leavy,11,137,3,27,8,110,12,6,2012
850,Cincinnati,Cleveland,10/14/2012,Pete Morelli,12,85,7,50,5,35,14,6,2012
851,Detroit,Philadelphia,10/14/2012,Bill Vinovich,25,192,16,132,9,60,29,6,2012
852,St. Louis,Miami,10/14/2012,Gene Steratore,17,134,12,94,5,40,18,6,2012
853,Dallas,Baltimore,10/14/2012,Mike Carey,23,158,13,82,10,76,25,6,2012
854,Buffalo,Arizona,10/14/2012,Al Riveron,12,106,5,39,7,67,13,6,2012
855,New England,Seattle,10/14/2012,Clete Blakeman,10,115,6,80,4,35,15,6,2012
856,N.Y. Giants,San Francisco,10/14/2012,John Parry,8,55,2,20,6,35,9,6,2012
857,Minnesota,Washington,10/14/2012,Tony Corrente,12,95,5,29,7,66,12,6,2012
858,Green Bay,Houston,10/14/2012,Jerome Boger,11,120,4,51,7,69,14,6,2012
859,Denver,San Diego,10/15/2012,Jeff Triplette,19,145,10,81,9,64,20,6,2012
860,Seattle,San Francisco,10/18/2012,Walt Anderson,8,60,3,20,5,40,11,7,2012
861,Washington,N.Y. Giants,10/21/2012,Ed Hochuli,10,85,7,55,3,30,10,7,2012
862,Arizona,Minnesota,10/21/2012,Terry McAulay,16,117,9,82,7,35,18,7,2012
863,Dallas,Carolina,10/21/2012,Ron Winter,15,114,6,43,9,71,16,7,2012
864,New Orleans,Tampa Bay,10/21/2012,Jerome Boger,14,110,7,55,7,55,19,7,2012
865,Green Bay,St. Louis,10/21/2012,Bill Vinovich,9,60,3,30,6,30,15,7,2012
866,Baltimore,Houston,10/21/2012,Tony Corrente,10,116,5,56,5,60,11,7,2012
867,Cleveland,Indianapolis,10/21/2012,Carl Cheffers,16,125,9,75,7,50,16,7,2012
868,Tennessee,Buffalo,10/21/2012,Mike Carey,11,90,3,25,8,65,11,7,2012
869,N.Y. Jets,New England,10/21/2012,Jeff Triplette,14,100,8,60,6,40,17,7,2012
870,Jacksonville,Oakland,10/21/2012,Scott Green,15,150,6,92,9,58,15,7,2012
871,Pittsburgh,Cincinnati,10/21/2012,Clete Blakeman,7,70,5,50,2,20,10,7,2012
872,Detroit,Chicago,10/22/2012,Al Riveron,14,96,5,47,9,49,16,7,2012
873,Tampa Bay,Minnesota,10/25/2012,Ron Winter,9,81,4,49,5,32,12,8,2012
874,Jacksonville,Green Bay,10/28/2012,Carl Cheffers,12,110,7,77,5,33,12,8,2012
875,Miami,N.Y. Jets,10/28/2012,Walt Anderson,9,76,4,31,5,45,10,8,2012
876,San Diego,Cleveland,10/28/2012,Jerome Boger,7,50,3,15,4,35,7,8,2012
877,Indianapolis,Tennessee,10/28/2012,Al Riveron,13,110,5,45,8,65,15,8,2012
878,New England,St. Louis,10/28/2012,Walt Coleman,20,144,8,42,12,102,21,8,2012
879,Atlanta,Philadelphia,10/28/2012,Gene Steratore,12,97,6,40,6,57,17,8,2012
880,Carolina,Chicago,10/28/2012,Ed Hochuli,8,61,3,21,5,40,11,8,2012
881,Seattle,Detroit,10/28/2012,John Parry,7,71,2,10,5,61,11,8,2012
882,Washington,Pittsburgh,10/28/2012,Pete Morelli,10,75,7,55,3,20,14,8,2012
883,Oakland,Kansas City,10/28/2012,Bill Vinovich,7,60,2,20,5,40,9,8,2012
884,N.Y. Giants,Dallas,10/28/2012,Scott Green,8,55,5,45,3,10,11,8,2012
885,New Orleans,Denver,10/28/2012,Mike Carey,8,49,3,15,5,34,12,8,2012
886,San Francisco,Arizona,10/29/2012,Bill Leavy,17,131,10,80,7,51,18,8,2012
887,Kansas City,San Diego,11/1/2012,Al Riveron,13,91,5,37,8,54,14,9,2012
888,Carolina,Washington,11/4/2012,Carl Cheffers,20,157,7,60,13,97,22,9,2012
889,Arizona,Green Bay,11/4/2012,Walt Coleman,9,62,8,57,1,5,9,9,2012
890,Detroit,Jacksonville,11/4/2012,Gene Steratore,8,82,5,42,3,40,11,9,2012
891,Chicago,Tennessee,11/4/2012,Terry McAulay,14,105,5,37,9,68,16,9,2012
892,Denver,Cincinnati,11/4/2012,Scott Green,13,112,5,29,8,83,14,9,2012
893,Baltimore,Cleveland,11/4/2012,Jeff Triplette,13,113,9,82,4,31,18,9,2012
894,Buffalo,Houston,11/4/2012,Bill Vinovich,10,57,3,15,7,42,11,9,2012
895,Miami,Indianapolis,11/4/2012,Tony Corrente,19,170,8,79,11,91,23,9,2012
896,Minnesota,Seattle,11/4/2012,Jerome Boger,10,82,6,33,4,49,11,9,2012
897,Tampa Bay,Oakland,11/4/2012,Walt Anderson,23,196,14,116,9,80,25,9,2012
898,Pittsburgh,N.Y. Giants,11/4/2012,Bill Leavy,13,159,6,119,7,40,13,9,2012
899,Dallas,Atlanta,11/4/2012,John Parry,9,65,7,50,2,15,12,9,2012
900,Philadelphia,New Orleans,11/5/2012,Clete Blakeman,11,93,7,58,4,35,12,9,2012
901,Indianapolis,Jacksonville,11/8/2012,Terry McAulay,16,155,6,40,10,115,19,10,2012
902,Denver,Carolina,11/11/2012,Al Riveron,14,105,7,60,7,45,15,10,2012
903,San Diego,Tampa Bay,11/11/2012,Bill Vinovich,2,10,1,5,1,5,2,10,2012
904,Tennessee,Miami,11/11/2012,Walt Anderson,11,106,4,39,7,67,13,10,2012
905,Buffalo,New England,11/11/2012,Bill Leavy,21,221,14,148,7,73,22,10,2012
906,Oakland,Baltimore,11/11/2012,Ron Winter,14,146,10,105,4,41,16,10,2012
907,N.Y. Giants,Cincinnati,11/11/2012,Mike Carey,6,45,1,5,5,40,6,10,2012
908,Atlanta,New Orleans,11/11/2012,Tony Corrente,11,88,6,53,5,35,12,10,2012
909,Detroit,Minnesota,11/11/2012,Pete Morelli,13,104,6,57,7,47,13,10,2012
910,N.Y. Jets,Seattle,11/11/2012,Ed Hochuli,13,80,6,35,7,45,16,10,2012
911,Dallas,Philadelphia,11/11/2012,Walt Coleman,19,125,13,75,6,50,20,10,2012
912,St. Louis,San Francisco,11/11/2012,Clete Blakeman,20,151,13,85,7,66,22,10,2012
913,Houston,Chicago,11/11/2012,Gene Steratore,8,84,3,35,5,49,10,10,2012
914,Kansas City,Pittsburgh,11/12/2012,Carl Cheffers,8,95,6,76,2,19,10,10,2012
915,Miami,Buffalo,11/15/2012,Jeff Triplette,17,169,11,100,6,69,17,11,2012
916,Philadelphia,Washington,11/18/2012,Terry McAulay,22,150,9,70,13,80,25,11,2012
917,Green Bay,Detroit,11/18/2012,Ron Winter,16,130,9,80,7,50,19,11,2012
918,Arizona,Atlanta,11/18/2012,Bill Vinovich,10,78,5,43,5,35,11,11,2012
919,Tampa Bay,Carolina,11/18/2012,Bill Leavy,17,141,6,50,11,91,18,11,2012
920,Cleveland,Dallas,11/18/2012,Ed Hochuli,21,221,12,129,9,92,21,11,2012
921,N.Y. Jets,St. Louis,11/18/2012,Jerome Boger,8,50,3,20,5,30,10,11,2012
922,Indianapolis,New England,11/18/2012,John Parry,5,75,1,5,4,70,9,11,2012
923,Jacksonville,Houston,11/18/2012,Clete Blakeman,8,74,6,54,2,20,10,11,2012
924,Cincinnati,Kansas City,11/18/2012,Gene Steratore,14,84,9,54,5,30,15,11,2012
925,New Orleans,Oakland,11/18/2012,Pete Morelli,11,114,7,74,4,40,11,11,2012
926,San Diego,Denver,11/18/2012,Carl Cheffers,14,95,10,65,4,30,14,11,2012
927,Baltimore,Pittsburgh,11/18/2012,Walt Anderson,10,111,4,68,6,43,11,11,2012
928,Chicago,San Francisco,11/19/2012,Tony Corrente,11,105,6,55,5,50,11,11,2012
929,Houston,Detroit,11/22/2012,Walt Coleman,15,135,8,65,7,70,15,12,2012
930,Washington,Dallas,11/22/2012,Bill Leavy,12,86,5,41,7,45,14,12,2012
931,New England,N.Y. Jets,11/22/2012,Mike Carey,13,71,8,36,5,35,13,12,2012
932,Oakland,Cincinnati,11/25/2012,Al Riveron,6,50,3,25,3,25,7,12,2012
933,Pittsburgh,Cleveland,11/25/2012,Ron Winter,19,158,9,68,10,90,20,12,2012
934,Buffalo,Indianapolis,11/25/2012,Ed Hochuli,10,83,4,46,6,37,12,12,2012
935,Tennessee,Jacksonville,11/25/2012,Walt Anderson,11,72,6,42,5,30,12,12,2012
936,Denver,Kansas City,11/25/2012,Jerome Boger,11,85,4,35,7,50,13,12,2012
937,Minnesota,Chicago,11/25/2012,Scott Green,8,99,3,44,5,55,8,12,2012
938,Atlanta,Tampa Bay,11/25/2012,Jeff Triplette,7,39,2,15,5,24,9,12,2012
939,Seattle,Miami,11/25/2012,Clete Blakeman,12,74,10,59,2,15,13,12,2012
940,Baltimore,San Diego,11/25/2012,Gene Steratore,11,97,6,60,5,37,13,12,2012
941,San Francisco,New Orleans,11/25/2012,John Parry,14,121,10,68,4,53,16,12,2012
942,St. Louis,Arizona,11/25/2012,Tony Corrente,17,140,10,84,7,56,20,12,2012
943,Green Bay,N.Y. Giants,11/25/2012,Terry McAulay,11,73,7,49,4,24,14,12,2012
944,Carolina,Philadelphia,11/26/2012,Pete Morelli,11,131,6,101,5,30,15,12,2012
945,New Orleans,Atlanta,11/29/2012,Scott Green,10,55,5,30,5,25,10,13,2012
946,Seattle,Chicago,12/2/2012,Mike Carey,13,100,8,55,5,45,14,13,2012
947,Minnesota,Green Bay,12/2/2012,Ed Hochuli,15,126,5,48,10,78,20,13,2012
948,San Francisco,St. Louis,12/2/2012,Carl Cheffers,18,157,11,97,7,60,20,13,2012
949,Arizona,N.Y. Jets,12/2/2012,Walt Anderson,7,50,4,30,3,20,8,13,2012
950,Carolina,Kansas City,12/2/2012,John Parry,8,50,7,45,1,5,8,13,2012
951,Indianapolis,Detroit,12/2/2012,Bill Vinovich,12,97,4,36,8,61,15,13,2012
952,Jacksonville,Buffalo,12/2/2012,Pete Morelli,17,174,8,74,9,100,18,13,2012
953,New England,Miami,12/2/2012,Ron Winter,14,142,6,50,8,92,15,13,2012
954,Houston,Tennessee,12/2/2012,Tony Corrente,15,132,11,97,4,35,18,13,2012
955,Tampa Bay,Denver,12/2/2012,Terry McAulay,19,155,11,80,8,75,20,13,2012
956,Pittsburgh,Baltimore,12/2/2012,Al Riveron,12,120,4,50,8,70,12,13,2012
957,Cleveland,Oakland,12/2/2012,Bill Leavy,12,90,2,25,10,65,12,13,2012
958,Cincinnati,San Diego,12/2/2012,Walt Coleman,16,110,8,55,8,55,18,13,2012
959,Philadelphia,Dallas,12/2/2012,Jeff Triplette,8,65,1,5,7,60,11,13,2012
960,N.Y. Giants,Washington,12/3/2012,Jerome Boger,13,129,9,73,4,56,16,13,2012
961,Denver,Oakland,12/6/2012,Clete Blakeman,14,119,3,25,11,94,17,14,2012
962,Baltimore,Washington,12/9/2012,John Parry,16,126,8,56,8,70,16,14,2012
963,Kansas City,Cleveland,12/9/2012,Walt Anderson,12,90,5,35,7,55,12,14,2012
964,San Diego,Pittsburgh,12/9/2012,Scott Green,14,103,6,51,8,52,15,14,2012
965,Tennessee,Indianapolis,12/9/2012,Pete Morelli,15,113,9,70,6,43,17,14,2012
966,N.Y. Jets,Jacksonville,12/9/2012,Al Riveron,8,69,1,15,7,54,8,14,2012
967,Chicago,Minnesota,12/9/2012,Walt Coleman,17,134,10,80,7,54,21,14,2012
968,Atlanta,Carolina,12/9/2012,Ed Hochuli,6,25,3,15,3,10,6,14,2012
969,Philadelphia,Tampa Bay,12/9/2012,Ron Winter,10,73,2,13,8,60,14,14,2012
970,St. Louis,Buffalo,12/9/2012,Gene Steratore,4,32,2,17,2,15,6,14,2012
971,Dallas,Cincinnati,12/9/2012,Bill Vinovich,14,119,6,49,8,70,16,14,2012
972,Miami,San Francisco,12/9/2012,Mike Carey,11,88,5,43,6,45,12,14,2012
973,New Orleans,N.Y. Giants,12/9/2012,Jeff Triplette,16,136,10,81,6,55,19,14,2012
974,Arizona,Seattle,12/9/2012,Carl Cheffers,19,176,9,79,10,97,22,14,2012
975,Detroit,Green Bay,12/9/2012,Tony Corrente,12,105,5,55,7,50,13,14,2012
976,Houston,New England,12/10/2012,Terry McAulay,13,126,7,70,6,56,17,14,2012
977,Cincinnati,Philadelphia,12/13/2012,Carl Cheffers,20,170,11,94,9,76,25,15,2012
978,Green Bay,Chicago,12/16/2012,Walt Anderson,18,195,8,104,10,91,22,15,2012
979,N.Y. Giants,Atlanta,12/16/2012,Bill Leavy,5,55,2,25,3,30,10,15,2012
980,Tampa Bay,New Orleans,12/16/2012,Mike Carey,13,139,7,84,6,55,14,15,2012
981,Minnesota,St. Louis,12/16/2012,Al Riveron,11,96,3,49,8,47,15,15,2012
982,Washington,Cleveland,12/16/2012,Bill Vinovich,11,75,6,45,5,30,12,15,2012
983,Jacksonville,Miami,12/16/2012,John Parry,15,129,10,88,5,41,17,15,2012
984,Denver,Baltimore,12/16/2012,Pete Morelli,13,112,7,51,6,61,13,15,2012
985,Indianapolis,Houston,12/16/2012,Jeff Triplette,17,148,8,79,9,69,24,15,2012
986,Detroit,Arizona,12/16/2012,Jerome Boger,13,113,7,63,6,50,15,15,2012
987,Carolina,San Diego,12/16/2012,Terry McAulay,15,118,6,48,9,70,17,15,2012
988,Seattle,Buffalo,12/16/2012,Scott Green,8,52,4,32,4,20,9,15,2012
989,Pittsburgh,Dallas,12/16/2012,Clete Blakeman,8,61,0,0,8,61,8,15,2012
990,Kansas City,Oakland,12/16/2012,Tony Corrente,12,122,7,60,5,62,14,15,2012
991,San Francisco,New England,12/16/2012,Ed Hochuli,14,161,6,88,8,73,16,15,2012
992,N.Y. Jets,Tennessee,12/17/2012,Walt Coleman,18,134,4,23,14,111,20,15,2012
993,Atlanta,Detroit,12/22/2012,Gene Steratore,5,40,3,20,2,20,9,16,2012
994,Tennessee,Green Bay,12/23/2012,Clete Blakeman,6,45,5,35,1,10,10,16,2012
995,Oakland,Carolina,12/23/2012,Jerome Boger,16,167,6,70,10,97,22,16,2012
996,Buffalo,Miami,12/23/2012,Walt Anderson,14,118,11,93,3,25,14,16,2012
997,Cincinnati,Pittsburgh,12/23/2012,Mike Carey,12,118,7,55,5,63,14,16,2012
998,New England,Jacksonville,12/23/2012,Jeff Triplette,9,86,4,39,5,47,11,16,2012
999,Indianapolis,Kansas City,12/23/2012,Ron Winter,13,123,4,48,9,75,13,16,2012
1000,New Orleans,Dallas,12/23/2012,Walt Coleman,11,74,6,42,5,32,14,16,2012
1001,Washington,Philadelphia,12/23/2012,Ed Hochuli,7,54,3,24,4,30,10,16,2012
1002,St. Louis,Tampa Bay,12/23/2012,Scott Green,10,69,9,64,1,5,10,16,2012
1003,N.Y. Giants,Baltimore,12/23/2012,Carl Cheffers,15,144,6,52,9,92,16,16,2012
1004,Minnesota,Houston,12/23/2012,John Parry,14,112,5,52,9,60,15,16,2012
1005,Cleveland,Denver,12/23/2012,Al Riveron,21,153,10,69,11,84,26,16,2012
1006,Chicago,Arizona,12/23/2012,Terry McAulay,6,37,2,12,4,25,8,16,2012
1007,San Francisco,Seattle,12/23/2012,Bill Vinovich,10,103,6,58,4,45,12,16,2012
1008,San Diego,N.Y. Jets,12/23/2012,Pete Morelli,11,93,5,53,6,40,11,16,2012
1009,N.Y. Jets,Buffalo,12/30/2012,Terry McAulay,8,69,4,45,4,24,11,17,2012
1010,Miami,New England,12/30/2012,Jerome Boger,9,71,3,23,6,48,9,17,2012
1011,Baltimore,Cincinnati,12/30/2012,Ron Winter,14,142,10,102,4,40,14,17,2012
1012,Cleveland,Pittsburgh,12/30/2012,Walt Coleman,12,137,9,79,3,58,13,17,2012
1013,Houston,Indianapolis,12/30/2012,Clete Blakeman,12,88,9,64,3,24,15,17,2012
1014,Jacksonville,Tennessee,12/30/2012,Bill Vinovich,12,78,7,35,5,43,15,17,2012
1015,Philadelphia,N.Y. Giants,12/30/2012,Tony Corrente,7,57,6,52,1,5,10,17,2012
1016,Dallas,Washington,12/30/2012,Walt Anderson,3,26,1,6,2,20,5,17,2012
1017,Chicago,Detroit,12/30/2012,Bill Leavy,7,64,3,35,4,29,8,17,2012
1018,Green Bay,Minnesota,12/30/2012,Mike Carey,17,141,7,43,10,98,18,17,2012
1019,Tampa Bay,Atlanta,12/30/2012,Carl Cheffers,4,30,2,15,2,15,6,17,2012
1020,Carolina,New Orleans,12/30/2012,Al Riveron,9,91,4,36,5,55,13,17,2012
1021,Kansas City,Denver,12/30/2012,Ed Hochuli,10,62,5,32,5,30,11,17,2012
1022,Oakland,San Diego,12/30/2012,John Parry,17,127,9,67,8,60,19,17,2012
1023,Arizona,San Francisco,12/30/2012,Pete Morelli,8,59,5,34,3,25,8,17,2012
1024,St. Louis,Seattle,12/30/2012,Jeff Triplette,24,178,14,98,10,80,28,17,2012
1025,Baltimore,Denver,9/5/2013,Walt Coleman,15,114,7,53,8,61,21,1,2013
1026,New England,Buffalo,9/8/2013,Walt Anderson,14,111,4,36,10,75,17,1,2013
1027,Seattle,Carolina,9/8/2013,Jeff Triplette,13,155,9,109,4,46,15,1,2013
1028,Cincinnati,Chicago,9/8/2013,Carl Cheffers,12,143,8,84,4,59,12,1,2013
1029,Miami,Cleveland,9/8/2013,Mike Carey,19,134,10,77,9,57,20,1,2013
1030,Minnesota,Detroit,9/8/2013,John Parry,16,140,5,52,11,88,17,1,2013
1031,Oakland,Indianapolis,9/8/2013,Bill Vinovich,11,82,8,51,3,31,13,1,2013
1032,Kansas City,Jacksonville,9/8/2013,Pete Morelli,8,50,3,20,5,30,8,1,2013
1033,Tampa Bay,N.Y. Jets,9/8/2013,Ed Hochuli,19,147,13,102,6,45,22,1,2013
1034,Atlanta,New Orleans,9/8/2013,Gene Steratore,8,76,2,19,6,57,8,1,2013
1035,Tennessee,Pittsburgh,9/8/2013,Jerome Boger,10,107,6,60,4,47,11,1,2013
1036,Arizona,St. Louis,9/8/2013,Clete Blakeman,13,127,6,68,7,59,15,1,2013
1037,Green Bay,San Francisco,9/8/2013,Bill Leavy,16,129,5,44,11,85,17,1,2013
1038,N.Y. Giants,Dallas,9/8/2013,Tony Corrente,11,92,6,52,5,40,13,1,2013
1039,Philadelphia,Washington,9/9/2013,Ron Winter,18,140,8,65,10,75,23,1,2013
1040,Houston,San Diego,9/9/2013,Scott Green,14,128,7,73,7,55,16,1,2013
1041,N.Y. Jets,New England,9/12/2013,Carl Cheffers,11,96,8,66,3,30,13,2,2013
1042,St. Louis,Atlanta,9/15/2013,Scott Green,14,106,7,53,7,53,14,2,2013
1043,Cleveland,Baltimore,9/15/2013,Bill Vinovich,8,74,5,33,3,41,9,2,2013
1044,Carolina,Buffalo,9/15/2013,Walt Coleman,10,85,3,30,7,55,11,2,2013
1045,Minnesota,Chicago,9/15/2013,Ed Hochuli,7,60,3,25,4,35,9,2,2013
1046,Washington,Green Bay,9/15/2013,Tony Corrente,11,118,7,78,4,40,14,2,2013
1047,Tennessee,Houston,9/15/2013,Jeff Triplette,14,110,9,70,5,40,16,2,2013
1048,Miami,Indianapolis,9/15/2013,Clete Blakeman,3,13,0,0,3,13,4,2,2013
1049,Dallas,Kansas City,9/15/2013,Jerome Boger,15,72,5,27,10,45,18,2,2013
1050,San Diego,Philadelphia,9/15/2013,Terry McAulay,13,114,4,32,9,82,15,2,2013
1051,Detroit,Arizona,9/15/2013,Pete Morelli,15,141,8,101,7,40,15,2,2013
1052,New Orleans,Tampa Bay,9/15/2013,Bill Leavy,15,153,5,35,10,118,16,2,2013
1053,Denver,N.Y. Giants,9/15/2013,Gene Steratore,17,148,13,132,4,16,18,2,2013
1054,Jacksonville,Oakland,9/15/2013,Walt Anderson,15,100,10,70,5,30,18,2,2013
1055,San Francisco,Seattle,9/15/2013,John Parry,22,205,12,121,10,84,23,2,2013
1056,Pittsburgh,Cincinnati,9/16/2013,Mike Carey,12,113,3,29,9,84,13,2,2013
1057,Kansas City,Philadelphia,9/19/2013,Walt Anderson,15,110,9,65,6,45,17,3,2013
1058,Houston,Baltimore,9/22/2013,John Parry,24,200,14,113,10,87,26,3,2013
1059,Green Bay,Cincinnati,9/22/2013,Clete Blakeman,9,98,4,55,5,43,12,3,2013
1060,St. Louis,Dallas,9/22/2013,Carl Cheffers,11,113,5,41,6,72,16,3,2013
1061,Atlanta,Miami,9/22/2013,Ron Winter,9,72,7,59,2,13,9,3,2013
1062,Cleveland,Minnesota,9/22/2013,Bill Leavy,9,82,5,47,4,35,9,3,2013
1063,Buffalo,N.Y. Jets,9/22/2013,Scott Green,27,255,7,87,20,168,31,3,2013
1064,Tampa Bay,New England,9/22/2013,Jeff Triplette,10,98,4,48,6,50,13,3,2013
1065,Arizona,New Orleans,9/22/2013,Walt Coleman,7,48,3,18,4,30,10,3,2013
1066,San Diego,Tennessee,9/22/2013,Tony Corrente,16,161,5,45,11,116,19,3,2013
1067,Detroit,Washington,9/22/2013,Ed Hochuli,14,116,8,71,6,45,16,3,2013
1068,N.Y. Giants,Carolina,9/22/2013,Mike Carey,10,77,6,45,4,32,12,3,2013
1069,Indianapolis,San Francisco,9/22/2013,Terry McAulay,7,58,1,10,6,48,7,3,2013
1070,Jacksonville,Seattle,9/22/2013,Bill Vinovich,8,69,4,45,4,24,9,3,2013
1071,Chicago,Pittsburgh,9/22/2013,Pete Morelli,9,84,3,25,6,59,10,3,2013
1072,Oakland,Denver,9/23/2013,Jerome Boger,13,117,8,77,5,40,14,3,2013
1073,San Francisco,St. Louis,9/26/2013,Jeff Triplette,18,167,10,85,8,82,21,4,2013
1074,Baltimore,Buffalo,9/29/2013,Jerome Boger,19,158,8,59,11,99,21,4,2013
1075,Cincinnati,Cleveland,9/29/2013,Ron Winter,8,105,3,25,5,80,11,4,2013
1076,Chicago,Detroit,9/29/2013,Mike Carey,7,55,4,30,3,25,7,4,2013
1077,Seattle,Houston,9/29/2013,Tony Corrente,15,148,9,62,6,86,17,4,2013
1078,Indianapolis,Jacksonville,9/29/2013,John Parry,16,123,7,58,9,65,17,4,2013
1079,N.Y. Giants,Kansas City,9/29/2013,Terry McAulay,14,127,7,65,7,62,14,4,2013
1080,Pittsburgh,Minnesota,9/29/2013,Clete Blakeman,9,139,4,50,5,89,9,4,2013
1081,Arizona,Tampa Bay,9/29/2013,Gene Steratore,18,163,10,90,8,73,19,4,2013
1082,N.Y. Jets,Tennessee,9/29/2013,Walt Anderson,14,96,10,66,4,30,16,4,2013
1083,Philadelphia,Denver,9/29/2013,Pete Morelli,10,87,8,62,2,25,11,4,2013
1084,Washington,Oakland,9/29/2013,Bill Leavy,7,54,3,29,4,25,8,4,2013
1085,Dallas,San Diego,9/29/2013,Ed Hochuli,12,118,5,33,7,85,15,4,2013
1086,New England,Atlanta,9/29/2013,Walt Coleman,15,148,9,93,6,55,17,4,2013
1087,Miami,New Orleans,9/30/2013,Bill Vinovich,11,70,5,25,6,45,11,4,2013
1088,Buffalo,Cleveland,10/3/2013,Pete Morelli,13,122,7,56,6,66,14,5,2013
1089,New Orleans,Chicago,10/6/2013,Scott Green,8,53,2,10,6,43,10,5,2013
1090,New England,Cincinnati,10/6/2013,Gene Steratore,7,59,0,0,7,59,8,5,2013
1091,Detroit,Green Bay,10/6/2013,Jerome Boger,17,122,7,50,10,72,20,5,2013
1092,Seattle,Indianapolis,10/6/2013,Ron Winter,10,120,7,85,3,35,12,5,2013
1093,Baltimore,Miami,10/6/2013,Carl Cheffers,10,129,6,64,4,65,12,5,2013
1094,Philadelphia,N.Y. Giants,10/6/2013,Walt Coleman,20,224,8,88,12,136,23,5,2013
1095,Jacksonville,St. Louis,10/6/2013,Tony Corrente,10,98,4,45,6,53,10,5,2013
1096,Kansas City,Tennessee,10/6/2013,Bill Vinovich,15,96,9,61,6,35,15,5,2013
1097,Carolina,Arizona,10/6/2013,John Parry,12,109,9,79,3,30,14,5,2013
1098,Denver,Dallas,10/6/2013,Terry McAulay,14,136,5,55,9,81,17,5,2013
1099,San Diego,Oakland,10/6/2013,Jeff Triplette,13,115,5,30,8,85,18,5,2013
1100,Houston,San Francisco,10/6/2013,Mike Carey,10,69,7,52,3,17,11,5,2013
1101,N.Y. Jets,Atlanta,10/7/2013,Bill Leavy,10,70,6,24,4,46,11,5,2013
1102,N.Y. Giants,Chicago,10/10/2013,John Parry,9,82,4,31,5,51,11,6,2013
1103,Green Bay,Baltimore,10/13/2013,Gene Steratore,14,95,8,55,6,40,15,6,2013
1104,Cincinnati,Buffalo,10/13/2013,Ed Hochuli,12,105,8,78,4,27,13,6,2013
1105,Detroit,Cleveland,10/13/2013,Walt Coleman,17,152,8,65,9,87,18,6,2013
1106,St. Louis,Houston,10/13/2013,Bill Leavy,16,169,9,74,7,95,17,6,2013
1107,Oakland,Kansas City,10/13/2013,Mike Carey,15,88,11,68,4,20,17,6,2013
1108,Carolina,Minnesota,10/13/2013,Ron Winter,11,95,6,40,5,55,13,6,2013
1109,Pittsburgh,N.Y. Jets,10/13/2013,Terry McAulay,12,109,7,49,5,60,13,6,2013
1110,Philadelphia,Tampa Bay,10/13/2013,Clete Blakeman,11,103,3,31,8,72,12,6,2013
1111,Jacksonville,Denver,10/13/2013,Jeff Triplette,11,93,7,62,4,31,11,6,2013
1112,Tennessee,Seattle,10/13/2013,Carl Cheffers,13,109,7,44,6,65,13,6,2013
1113,New Orleans,New England,10/13/2013,Tony Corrente,11,89,7,56,4,33,14,6,2013
1114,Arizona,San Francisco,10/13/2013,Scott Green,10,73,6,38,4,35,14,6,2013
1115,Washington,Dallas,10/13/2013,Walt Anderson,19,184,12,104,7,80,20,6,2013
1116,Indianapolis,San Diego,10/14/2013,Pete Morelli,10,53,5,28,5,25,11,6,2013
1117,Seattle,Arizona,10/17/2013,Terry McAulay,13,92,10,70,3,22,16,7,2013
1118,Tampa Bay,Atlanta,10/20/2013,Walt Anderson,20,204,11,103,9,101,23,7,2013
1119,St. Louis,Carolina,10/20/2013,Bill Vinovich,15,127,8,68,7,59,16,7,2013
1120,Cincinnati,Detroit,10/20/2013,Scott Green,10,80,6,50,4,30,13,7,2013
1121,Cleveland,Green Bay,10/20/2013,Jeff Triplette,22,203,12,106,10,97,22,7,2013
1122,San Diego,Jacksonville,10/20/2013,Walt Coleman,14,106,8,61,6,45,15,7,2013
1123,Houston,Kansas City,10/20/2013,Ed Hochuli,9,64,4,40,5,24,11,7,2013
1124,Buffalo,Miami,10/20/2013,Gene Steratore,10,85,6,53,4,32,11,7,2013
1125,New England,N.Y. Jets,10/20/2013,Jerome Boger,16,145,7,100,9,45,18,7,2013
1126,Dallas,Philadelphia,10/20/2013,John Parry,17,108,12,75,5,33,20,7,2013
1127,Chicago,Washington,10/20/2013,Clete Blakeman,10,77,5,30,5,47,10,7,2013
1128,San Francisco,Tennessee,10/20/2013,Ron Winter,15,142,5,42,10,100,19,7,2013
1129,Baltimore,Pittsburgh,10/20/2013,Bill Leavy,16,117,9,67,7,50,18,7,2013
1130,Denver,Indianapolis,10/20/2013,Carl Cheffers,18,155,12,103,6,52,25,7,2013
1131,Minnesota,N.Y. Giants,10/21/2013,Tony Corrente,8,110,3,38,5,72,10,7,2013
1132,Carolina,Tampa Bay,10/24/2013,Jerome Boger,9,80,6,59,3,21,10,8,2013
1133,Dallas,Detroit,10/27/2013,Bill Vinovich,10,92,2,31,8,61,11,8,2013
1134,San Francisco,Jacksonville,10/27/2013,Ed Hochuli,10,111,4,35,6,76,10,8,2013
1135,Cleveland,Kansas City,10/27/2013,Clete Blakeman,14,101,9,70,5,31,16,8,2013
1136,Miami,New England,10/27/2013,Walt Anderson,12,96,7,61,5,35,12,8,2013
1137,Buffalo,New Orleans,10/27/2013,Terry McAulay,14,104,6,45,8,59,14,8,2013
1138,N.Y. Giants,Philadelphia,10/27/2013,Carl Cheffers,15,140,11,92,4,48,16,8,2013
1139,Pittsburgh,Oakland,10/27/2013,John Parry,9,51,3,12,6,39,11,8,2013
1140,N.Y. Jets,Cincinnati,10/27/2013,Pete Morelli,8,114,4,69,4,45,9,8,2013
1141,Atlanta,Arizona,10/27/2013,Mike Carey,18,107,10,55,8,52,19,8,2013
1142,Washington,Denver,10/27/2013,Ron Winter,7,62,1,5,6,57,10,8,2013
1143,Green Bay,Minnesota,10/27/2013,Scott Green,13,166,6,120,7,46,13,8,2013
1144,Seattle,St. Louis,10/28/2013,Gene Steratore,18,136,10,83,8,53,21,8,2013
1145,Cincinnati,Miami,10/31/2013,Bill Leavy,5,88,3,63,2,25,6,9,2013
1146,Kansas City,Buffalo,11/3/2013,Ron Winter,11,86,5,38,6,48,12,9,2013
1147,Atlanta,Carolina,11/3/2013,Tony Corrente,9,74,7,59,2,15,9,9,2013
1148,Minnesota,Dallas,11/3/2013,Jeff Triplette,9,80,4,35,5,45,11,9,2013
1149,New Orleans,N.Y. Jets,11/3/2013,Clete Blakeman,17,121,9,59,8,62,18,9,2013
1150,Tennessee,St. Louis,11/3/2013,Pete Morelli,9,74,3,30,6,44,9,9,2013
1151,San Diego,Washington,11/3/2013,Jerome Boger,14,128,7,63,7,65,15,9,2013
1152,Philadelphia,Oakland,11/3/2013,Ed Hochuli,15,122,7,52,8,70,19,9,2013
1153,Tampa Bay,Seattle,11/3/2013,Mike Carey,14,166,8,99,6,67,16,9,2013
1154,Baltimore,Cleveland,11/3/2013,Scott Green,15,135,9,80,6,55,15,9,2013
1155,Pittsburgh,New England,11/3/2013,Walt Coleman,11,126,8,96,3,30,12,9,2013
1156,Indianapolis,Houston,11/3/2013,Bill Vinovich,8,101,3,15,5,86,9,9,2013
1157,Chicago,Green Bay,11/4/2013,Walt Anderson,4,45,4,45,0,0,5,9,2013
1158,Washington,Minnesota,11/7/2013,Ed Hochuli,9,70,8,63,1,7,10,10,2013
1159,Seattle,Atlanta,11/10/2013,Bill Vinovich,10,95,9,80,1,15,11,10,2013
1160,Cincinnati,Baltimore,11/10/2013,Walt Coleman,17,199,9,134,8,65,18,10,2013
1161,Detroit,Chicago,11/10/2013,Bill Leavy,10,90,5,51,5,39,10,10,2013
1162,Philadelphia,Green Bay,11/10/2013,Mike Carey,10,96,5,65,5,31,12,10,2013
1163,St. Louis,Indianapolis,11/10/2013,Terry McAulay,10,66,8,46,2,20,11,10,2013
1164,Oakland,N.Y. Giants,11/10/2013,Pete Morelli,9,70,8,65,1,5,11,10,2013
1165,Buffalo,Pittsburgh,11/10/2013,Scott Green,10,72,4,30,6,42,13,10,2013
1166,Jacksonville,Tennessee,11/10/2013,John Parry,10,64,4,19,6,45,12,10,2013
1167,Carolina,San Francisco,11/10/2013,Carl Cheffers,7,50,3,25,4,25,9,10,2013
1168,Houston,Arizona,11/10/2013,Gene Steratore,12,82,7,53,5,29,12,10,2013
1169,Denver,San Diego,11/10/2013,Tony Corrente,9,68,3,28,6,40,9,10,2013
1170,Dallas,New Orleans,11/10/2013,Jerome Boger,17,126,11,82,6,44,18,10,2013
1171,Miami,Tampa Bay,11/11/2013,Jeff Triplette,13,140,4,70,9,70,13,10,2013
1172,Indianapolis,Tennessee,11/14/2013,Mike Carey,9,85,5,51,4,34,12,11,2013
1173,N.Y. Jets,Buffalo,11/17/2013,Bill Leavy,12,88,4,24,8,64,12,11,2013
1174,Baltimore,Chicago,11/17/2013,Gene Steratore,18,157,5,46,13,111,21,11,2013
1175,Cleveland,Cincinnati,11/17/2013,Carl Cheffers,13,104,5,40,8,64,15,11,2013
1176,Oakland,Houston,11/17/2013,Ron Winter,17,127,8,77,9,50,21,11,2013
1177,Arizona,Jacksonville,11/17/2013,Jeff Triplette,11,82,5,42,6,40,12,11,2013
1178,San Diego,Miami,11/17/2013,Pete Morelli,13,91,10,76,3,15,13,11,2013
1179,Washington,Philadelphia,11/17/2013,Walt Coleman,13,107,4,39,9,68,15,11,2013
1180,Detroit,Pittsburgh,11/17/2013,Walt Anderson,12,68,8,45,4,23,14,11,2013
1181,Atlanta,Tampa Bay,11/17/2013,Ed Hochuli,18,166,7,45,11,121,19,11,2013
1182,Kansas City,Denver,11/17/2013,John Parry,22,135,9,53,13,82,23,11,2013
1183,San Francisco,New Orleans,11/17/2013,Tony Corrente,9,93,5,45,4,48,10,11,2013
1184,Minnesota,Seattle,11/17/2013,Jerome Boger,11,116,4,20,7,96,11,11,2013
1185,Green Bay,N.Y. Giants,11/17/2013,Terry McAulay,8,68,5,38,3,30,13,11,2013
1186,New England,Carolina,11/18/2013,Clete Blakeman,12,97,5,50,7,47,12,11,2013
1187,New Orleans,Atlanta,11/21/2013,Ron Winter,8,91,5,66,3,25,10,12,2013
1188,N.Y. Jets,Baltimore,11/24/2013,Jeff Triplette,11,97,6,56,5,41,12,12,2013
1189,Pittsburgh,Cleveland,11/24/2013,Terry McAulay,4,18,2,8,2,10,5,12,2013
1190,Tampa Bay,Detroit,11/24/2013,Clete Blakeman,14,106,9,67,5,39,16,12,2013
1191,Minnesota,Green Bay,11/24/2013,Bill Vinovich,12,103,5,53,7,50,15,12,2013
1192,Jacksonville,Houston,11/24/2013,Mike Carey,9,85,7,63,2,22,10,12,2013
1193,San Diego,Kansas City,11/24/2013,Walt Coleman,16,159,9,97,7,62,17,12,2013
1194,Carolina,Miami,11/24/2013,Scott Green,14,111,8,56,6,55,15,12,2013
1195,Chicago,St. Louis,11/24/2013,Jerome Boger,16,123,10,84,6,39,19,12,2013
1196,Indianapolis,Arizona,11/24/2013,Bill Leavy,15,173,6,89,9,84,15,12,2013
1197,Tennessee,Oakland,11/24/2013,Carl Cheffers,14,150,10,100,4,50,14,12,2013
1198,Dallas,N.Y. Giants,11/24/2013,Walt Anderson,22,166,11,85,11,81,23,12,2013
1199,Denver,New England,11/24/2013,Gene Steratore,14,121,9,85,5,36,14,12,2013
1200,San Francisco,Washington,11/25/2013,John Parry,8,55,4,25,4,30,8,12,2013
1201,Green Bay,Detroit,11/28/2013,Gene Steratore,8,75,3,25,5,50,10,13,2013
1202,Oakland,Dallas,11/28/2013,Scott Green,16,111,10,71,6,40,16,13,2013
1203,Pittsburgh,Baltimore,11/28/2013,Clete Blakeman,13,106,4,51,9,55,13,13,2013
1204,Tampa Bay,Carolina,12/1/2013,Ron Winter,7,55,4,30,3,25,8,13,2013
1205,Jacksonville,Cleveland,12/1/2013,Bill Leavy,14,85,5,35,9,50,14,13,2013
1206,Tennessee,Indianapolis,12/1/2013,Walt Coleman,13,124,6,74,7,50,15,13,2013
1207,Denver,Kansas City,12/1/2013,Terry McAulay,19,177,10,75,9,102,20,13,2013
1208,Chicago,Minnesota,12/1/2013,Carl Cheffers,12,111,6,51,6,60,13,13,2013
1209,Miami,N.Y. Jets,12/1/2013,Mike Carey,7,53,3,28,4,25,7,13,2013
1210,Arizona,Philadelphia,12/1/2013,Tony Corrente,11,103,6,55,5,48,13,13,2013
1211,Atlanta,Buffalo,12/1/2013,Walt Anderson,14,124,8,75,6,49,15,13,2013
1212,St. Louis,San Francisco,12/1/2013,Bill Vinovich,20,190,11,105,9,85,20,13,2013
1213,New England,Houston,12/1/2013,Pete Morelli,2,25,0,0,2,25,2,13,2013
1214,Cincinnati,San Diego,12/1/2013,John Parry,8,75,3,30,5,45,9,13,2013
1215,N.Y. Giants,Washington,12/1/2013,Jeff Triplette,9,56,1,1,8,55,11,13,2013
1216,New Orleans,Seattle,12/2/2013,Ed Hochuli,15,118,7,52,8,66,16,13,2013
1217,Houston,Jacksonville,12/5/2013,Tony Corrente,22,234,14,177,8,57,23,14,2013
1218,Minnesota,Baltimore,12/8/2013,Pete Morelli,11,135,6,90,5,45,12,14,2013
1219,Indianapolis,Cincinnati,12/8/2013,Jeff Triplette,13,107,6,47,7,60,13,14,2013
1220,Cleveland,New England,12/8/2013,Jerome Boger,13,116,7,75,6,41,15,14,2013
1221,Oakland,N.Y. Jets,12/8/2013,Gene Steratore,8,67,4,31,4,36,10,14,2013
1222,Carolina,New Orleans,12/8/2013,Walt Anderson,10,80,5,35,5,45,13,14,2013
1223,Detroit,Philadelphia,12/8/2013,Ed Hochuli,10,53,9,48,1,5,10,14,2013
1224,Miami,Pittsburgh,12/8/2013,John Parry,9,65,4,31,5,34,9,14,2013
1225,Buffalo,Tampa Bay,12/8/2013,Bill Vinovich,19,190,11,114,8,76,21,14,2013
1226,Kansas City,Washington,12/8/2013,Carl Cheffers,7,57,3,30,4,27,9,14,2013
1227,Tennessee,Denver,12/8/2013,Scott Green,15,126,8,66,7,60,17,14,2013
1228,St. Louis,Arizona,12/8/2013,Walt Coleman,17,121,11,90,6,31,19,14,2013
1229,N.Y. Giants,San Diego,12/8/2013,Ron Winter,13,102,7,72,6,30,15,14,2013
1230,Seattle,San Francisco,12/8/2013,Clete Blakeman,16,155,9,85,7,70,19,14,2013
1231,Atlanta,Green Bay,12/8/2013,Bill Leavy,5,25,3,15,2,10,6,14,2013
1232,Dallas,Chicago,12/9/2013,Terry McAulay,6,65,4,50,2,15,7,14,2013
1233,San Diego,Denver,12/12/2013,Bill Vinovich,10,78,4,35,6,43,10,15,2013
1234,Washington,Atlanta,12/15/2013,Gene Steratore,16,139,9,66,7,73,21,15,2013
1235,Chicago,Cleveland,12/15/2013,Jeff Triplette,16,130,7,40,9,90,17,15,2013
1236,Houston,Indianapolis,12/15/2013,Jerome Boger,18,150,14,114,4,36,20,15,2013
1237,Buffalo,Jacksonville,12/15/2013,Ron Winter,13,147,7,67,6,80,15,15,2013
1238,New England,Miami,12/15/2013,Tony Corrente,5,23,1,2,4,21,7,15,2013
1239,Philadelphia,Minnesota,12/15/2013,Walt Anderson,12,119,9,94,3,25,12,15,2013
1240,Seattle,N.Y. Giants,12/15/2013,Bill Leavy,13,88,8,50,5,38,15,15,2013
1241,New Orleans,St. Louis,12/15/2013,Mike Carey,12,107,8,77,4,30,13,15,2013
1242,San Francisco,Tampa Bay,12/15/2013,Scott Green,12,94,8,62,4,32,14,15,2013
1243,Arizona,Tennessee,12/15/2013,Pete Morelli,12,85,9,69,3,16,12,15,2013
1244,N.Y. Jets,Carolina,12/15/2013,Terry McAulay,9,79,3,20,6,59,11,15,2013
1245,Kansas City,Oakland,12/15/2013,Clete Blakeman,18,181,8,91,10,90,20,15,2013
1246,Green Bay,Dallas,12/15/2013,Walt Coleman,14,138,7,59,7,79,15,15,2013
1247,Cincinnati,Pittsburgh,12/15/2013,Ed Hochuli,10,75,6,50,4,25,10,15,2013
1248,Baltimore,Detroit,12/16/2013,Carl Cheffers,15,149,7,60,8,89,17,15,2013
1249,Miami,Buffalo,12/22/2013,Clete Blakeman,10,68,6,37,4,31,12,16,2013
1250,New Orleans,Carolina,12/22/2013,Gene Steratore,7,66,4,40,3,26,9,16,2013
1251,Minnesota,Cincinnati,12/22/2013,Terry McAulay,11,95,5,40,6,55,13,16,2013
1252,Denver,Houston,12/22/2013,Ed Hochuli,12,124,8,67,4,57,15,16,2013
1253,Tennessee,Jacksonville,12/22/2013,Bill Vinovich,5,19,1,4,4,15,5,16,2013
1254,Indianapolis,Kansas City,12/22/2013,Tony Corrente,10,96,3,31,7,65,12,16,2013
1255,Cleveland,N.Y. Jets,12/22/2013,Pete Morelli,9,59,3,24,6,35,9,16,2013
1256,Chicago,Philadelphia,12/22/2013,Mike Carey,4,25,2,10,2,15,4,16,2013
1257,Tampa Bay,St. Louis,12/22/2013,John Parry,10,111,3,26,7,85,12,16,2013
1258,Dallas,Washington,12/22/2013,Bill Leavy,14,86,6,42,8,44,17,16,2013
1259,N.Y. Giants,Detroit,12/22/2013,Jerome Boger,12,90,5,30,7,60,13,16,2013
1260,Arizona,Seattle,12/22/2013,Scott Green,16,148,7,46,9,102,17,16,2013
1261,Pittsburgh,Green Bay,12/22/2013,Carl Cheffers,16,148,7,58,9,90,20,16,2013
1262,Oakland,San Diego,12/22/2013,Walt Anderson,15,97,12,73,3,24,19,16,2013
1263,New England,Baltimore,12/22/2013,Ron Winter,16,141,7,58,9,83,19,16,2013
1264,Atlanta,San Francisco,12/23/2013,Walt Coleman,12,82,5,37,7,45,14,16,2013
1265,Carolina,Atlanta,12/29/2013,John Parry,9,94,4,38,5,56,9,17,2013
1266,Green Bay,Chicago,12/29/2013,Clete Blakeman,6,55,1,15,5,40,6,17,2013
1267,Baltimore,Cincinnati,12/29/2013,Scott Green,16,132,6,56,10,76,17,17,2013
1268,Philadelphia,Dallas,12/29/2013,Gene Steratore,7,55,6,50,1,5,7,17,2013
1269,Jacksonville,Indianapolis,12/29/2013,Pete Morelli,7,60,5,50,2,10,7,17,2013
1270,N.Y. Jets,Miami,12/29/2013,Jerome Boger,10,74,5,36,5,38,11,17,2013
1271,Detroit,Minnesota,12/29/2013,Tony Corrente,10,77,6,52,4,25,12,17,2013
1272,Buffalo,New England,12/29/2013,Ed Hochuli,10,85,6,54,4,31,11,17,2013
1273,Tampa Bay,New Orleans,12/29/2013,Carl Cheffers,17,172,8,78,9,94,17,17,2013
1274,Washington,N.Y. Giants,12/29/2013,Bill Vinovich,6,50,3,30,3,20,6,17,2013
1275,Cleveland,Pittsburgh,12/29/2013,Mike Carey,5,45,3,30,2,15,6,17,2013
1276,Houston,Tennessee,12/29/2013,Terry McAulay,12,131,5,55,7,76,13,17,2013
1277,San Francisco,Arizona,12/29/2013,Walt Anderson,7,50,4,20,3,30,7,17,2013
1278,Denver,Oakland,12/29/2013,Ron Winter,8,66,6,56,2,10,8,17,2013
1279,Kansas City,San Diego,12/29/2013,Bill Leavy,5,27,1,5,4,22,6,17,2013
1280,St. Louis,Seattle,12/29/2013,Jeff Triplette,19,152,12,87,7,65,21,17,2013
1281,Green Bay,Seattle,9/4/2014,John Parry,12,134,8,65,4,69,12,1,2014
1282,New Orleans,Atlanta,9/7/2014,Bill Leavy,13,123,3,27,10,96,14,1,2014
1283,Cincinnati,Baltimore,9/7/2014,Gene Steratore,7,74,4,45,3,29,8,1,2014
1284,Buffalo,Chicago,9/7/2014,Brad Allen,13,151,9,108,4,43,19,1,2014
1285,Washington,Houston,9/7/2014,Jerome Boger,13,115,7,70,6,45,18,1,2014
1286,Tennessee,Kansas City,9/7/2014,Ron Torbert,15,135,12,110,3,25,20,1,2014
1287,New England,Miami,9/7/2014,Walt Anderson,13,126,9,100,4,26,16,1,2014
1288,Oakland,N.Y. Jets,9/7/2014,Craig Wrolstad,15,125,4,20,11,105,17,1,2014
1289,Jacksonville,Philadelphia,9/7/2014,Jeff Triplette,13,105,7,55,6,50,15,1,2014
1290,Cleveland,Pittsburgh,9/7/2014,Carl Cheffers,19,151,8,55,11,96,24,1,2014
1291,Minnesota,St. Louis,9/7/2014,Ed Hochuli,20,181,7,60,13,121,25,1,2014
1292,San Francisco,Dallas,9/7/2014,Terry McAulay,21,152,11,80,10,72,21,1,2014
1293,Carolina,Tampa Bay,9/7/2014,Pete Morelli,9,70,6,55,3,15,11,1,2014
1294,Indianapolis,Denver,9/7/2014,Tony Corrente,16,115,9,45,7,70,21,1,2014
1295,N.Y. Giants,Detroit,9/8/2014,Clete Blakeman,12,110,4,25,8,85,12,1,2014
1296,San Diego,Arizona,9/8/2014,Bill Vinovich,11,70,6,47,5,23,13,1,2014
1297,Pittsburgh,Baltimore,9/11/2014,Ed Hochuli,13,110,9,75,4,35,15,2,2014
1298,Miami,Buffalo,9/14/2014,Clete Blakeman,9,60,3,20,6,40,10,2,2014
1299,Detroit,Carolina,9/14/2014,Jerome Boger,9,78,5,33,4,45,13,2,2014
1300,Atlanta,Cincinnati,9/14/2014,Bill Vinovich,14,111,7,56,7,55,17,2,2014
1301,New Orleans,Cleveland,9/14/2014,Craig Wrolstad,9,69,5,39,4,30,11,2,2014
1302,New England,Minnesota,9/14/2014,Tony Corrente,22,221,15,163,7,58,26,2,2014
1303,Arizona,N.Y. Giants,9/14/2014,John Parry,16,141,7,71,9,70,20,2,2014
1304,Dallas,Tennessee,9/14/2014,Walt Coleman,9,60,4,25,5,35,9,2,2014
1305,Jacksonville,Washington,9/14/2014,Ron Torbert,17,142,6,44,11,98,24,2,2014
1306,Seattle,San Diego,9/14/2014,Pete Morelli,14,106,8,53,6,53,17,2,2014
1307,St. Louis,Tampa Bay,9/14/2014,Jeff Triplette,9,95,5,65,4,30,13,2,2014
1308,Kansas City,Denver,9/14/2014,Gene Steratore,18,133,7,62,11,71,22,2,2014
1309,N.Y. Jets,Green Bay,9/14/2014,Walt Anderson,10,117,7,82,3,35,14,2,2014
1310,Houston,Oakland,9/14/2014,Brad Allen,12,109,7,85,5,24,21,2,2014
1311,Chicago,San Francisco,9/14/2014,Carl Cheffers,26,176,10,58,16,118,33,2,2014
1312,Philadelphia,Indianapolis,9/15/2014,Terry McAulay,15,160,11,90,4,70,18,2,2014
1313,Tampa Bay,Atlanta,9/18/2014,Craig Wrolstad,16,160,11,110,5,50,23,3,2014
1314,San Diego,Buffalo,9/21/2014,John Parry,17,145,6,44,11,101,19,3,2014
1315,Tennessee,Cincinnati,9/21/2014,Brad Allen,18,149,11,99,7,50,20,3,2014
1316,Baltimore,Cleveland,9/21/2014,Bill Leavy,17,126,5,32,12,94,18,3,2014
1317,Green Bay,Detroit,9/21/2014,Carl Cheffers,11,70,5,30,6,40,11,3,2014
1318,Indianapolis,Jacksonville,9/21/2014,Walt Coleman,10,61,8,46,2,15,16,3,2014
1319,Oakland,New England,9/21/2014,Pete Morelli,12,108,6,49,6,59,17,3,2014
1320,Minnesota,New Orleans,9/21/2014,Walt Anderson,9,74,5,44,4,30,10,3,2014
1321,Houston,N.Y. Giants,9/21/2014,Terry McAulay,9,71,5,40,4,31,10,3,2014
1322,Washington,Philadelphia,9/21/2014,Tony Corrente,19,201,10,131,9,70,24,3,2014
1323,Dallas,St. Louis,9/21/2014,Clete Blakeman,11,134,3,15,8,119,13,3,2014
1324,San Francisco,Arizona,9/21/2014,Gene Steratore,14,143,9,107,5,36,21,3,2014
1325,Kansas City,Miami,9/21/2014,Jeff Triplette,10,88,4,23,6,65,11,3,2014
1326,Denver,Seattle,9/21/2014,Bill Vinovich,11,61,4,27,7,34,13,3,2014
1327,Pittsburgh,Carolina,9/21/2014,Ron Torbert,18,196,11,91,7,105,25,3,2014
1328,Chicago,N.Y. Jets,9/22/2014,Jerome Boger,15,173,9,95,6,78,15,3,2014
1329,N.Y. Giants,Washington,9/25/2014,Carl Cheffers,18,154,7,66,11,88,19,4,2014
1330,Carolina,Baltimore,9/28/2014,Craig Wrolstad,11,99,7,59,4,40,12,4,2014
1331,Green Bay,Chicago,9/28/2014,Terry McAulay,15,116,9,70,6,46,15,4,2014
1332,Buffalo,Houston,9/28/2014,Bill Vinovich,16,130,8,40,8,90,17,4,2014
1333,Tennessee,Indianapolis,9/28/2014,Jerome Boger,17,156,6,68,11,88,21,4,2014
1334,Atlanta,Minnesota,9/28/2014,Ron Torbert,11,90,5,50,6,40,14,4,2014
1335,Detroit,N.Y. Jets,9/28/2014,Walt Coleman,11,65,5,33,6,32,11,4,2014
1336,Miami,Oakland,9/28/2014,Bill Leavy,14,115,5,35,9,80,14,4,2014
1337,Tampa Bay,Pittsburgh,9/28/2014,Walt Anderson,22,175,9,50,13,125,31,4,2014
1338,Jacksonville,San Diego,9/28/2014,Clete Blakeman,10,89,3,32,7,57,12,4,2014
1339,Philadelphia,San Francisco,9/28/2014,Ed Hochuli,20,150,10,70,10,80,21,4,2014
1340,New Orleans,Dallas,9/28/2014,Gene Steratore,9,70,3,20,6,50,10,4,2014
1341,New England,Kansas City,9/29/2014,John Parry,7,65,3,30,4,35,7,4,2014
1342,Minnesota,Green Bay,10/2/2014,Brad Allen,14,121,9,91,5,30,14,5,2014
1343,Chicago,Carolina,10/5/2014,Tony Corrente,13,110,10,80,3,30,14,5,2014
1344,Houston,Dallas,10/5/2014,Pete Morelli,12,91,5,35,7,56,13,5,2014
1345,Buffalo,Detroit,10/5/2014,Craig Wrolstad,19,136,11,74,8,62,24,5,2014
1346,Baltimore,Indianapolis,10/5/2014,Walt Anderson,11,119,5,36,6,83,16,5,2014
1347,Pittsburgh,Jacksonville,10/5/2014,Terry McAulay,11,84,7,50,4,34,15,5,2014
1348,Tampa Bay,New Orleans,10/5/2014,Carl Cheffers,21,163,15,113,6,50,26,5,2014
1349,Atlanta,N.Y. Giants,10/5/2014,Ed Hochuli,11,96,8,81,3,15,15,5,2014
1350,St. Louis,Philadelphia,10/5/2014,Bill Vinovich,14,121,10,82,4,39,17,5,2014
1351,Cleveland,Tennessee,10/5/2014,Gene Steratore,14,142,7,74,7,68,26,5,2014
1352,Arizona,Denver,10/5/2014,Bill Leavy,10,82,3,15,7,67,11,5,2014
1353,N.Y. Jets,San Diego,10/5/2014,Ron Torbert,17,170,12,94,5,76,21,5,2014
1354,Kansas City,San Francisco,10/5/2014,Walt Coleman,6,39,4,29,2,10,8,5,2014
1355,Cincinnati,New England,10/5/2014,Jerome Boger,16,151,4,37,12,114,17,5,2014
1356,Seattle,Washington,10/6/2014,Jeff Triplette,16,120,13,90,3,30,16,5,2014
1357,Indianapolis,Houston,10/9/2014,Ron Torbert,10,117,5,51,5,66,11,6,2014
1358,Chicago,Atlanta,10/12/2014,Walt Anderson,13,99,7,47,6,52,18,6,2014
1359,New England,Buffalo,10/12/2014,Walt Coleman,17,167,9,60,8,107,23,6,2014
1360,Carolina,Cincinnati,10/12/2014,Carl Cheffers,21,179,8,60,13,119,23,6,2014
1361,Pittsburgh,Cleveland,10/12/2014,Pete Morelli,12,102,6,42,6,60,13,6,2014
1362,Green Bay,Miami,10/12/2014,Bill Vinovich,9,69,4,44,5,25,10,6,2014
1363,Detroit,Minnesota,10/12/2014,John Parry,14,100,5,40,9,60,17,6,2014
1364,Denver,N.Y. Jets,10/12/2014,Brad Allen,13,110,11,101,2,9,16,6,2014
1365,Baltimore,Tampa Bay,10/12/2014,Jerome Boger,13,113,8,70,5,43,14,6,2014
1366,Jacksonville,Tennessee,10/12/2014,Jeff Triplette,11,83,6,35,5,48,13,6,2014
1367,San Diego,Oakland,10/12/2014,Tony Corrente,18,139,7,60,11,79,19,6,2014
1368,Washington,Arizona,10/12/2014,Ed Hochuli,20,170,6,62,14,108,21,6,2014
1369,Dallas,Seattle,10/12/2014,Bill Leavy,15,104,6,46,9,58,17,6,2014
1370,N.Y. Giants,Philadelphia,10/12/2014,Clete Blakeman,13,99,10,74,3,25,14,6,2014
1371,San Francisco,St. Louis,10/13/2014,Craig Wrolstad,13,61,5,23,8,38,16,6,2014
1372,N.Y. Jets,New England,10/16/2014,Bill Leavy,16,134,7,70,9,64,17,7,2014
1373,Atlanta,Baltimore,10/19/2014,Carl Cheffers,16,148,7,76,9,72,17,7,2014
1374,Minnesota,Buffalo,10/19/2014,Ed Hochuli,15,98,7,50,8,48,18,7,2014
1375,Miami,Chicago,10/19/2014,Pete Morelli,9,99,7,84,2,15,14,7,2014
1376,New Orleans,Detroit,10/19/2014,Terry McAulay,21,205,12,134,9,71,25,7,2014
1377,Carolina,Green Bay,10/19/2014,Jeff Triplette,14,99,9,70,5,29,20,7,2014
1378,Cincinnati,Indianapolis,10/19/2014,Gene Steratore,12,77,4,20,8,57,13,7,2014
1379,Cleveland,Jacksonville,10/19/2014,Tony Corrente,11,75,8,50,3,25,13,7,2014
1380,Seattle,St. Louis,10/19/2014,Brad Allen,12,109,10,89,2,20,12,7,2014
1381,Tennessee,Washington,10/19/2014,Walt Anderson,18,146,11,96,7,50,22,7,2014
1382,Kansas City,San Diego,10/19/2014,Bill Vinovich,11,122,7,73,4,49,11,7,2014
1383,N.Y. Giants,Dallas,10/19/2014,Jerome Boger,12,86,6,40,6,46,14,7,2014
1384,Arizona,Oakland,10/19/2014,Clete Blakeman,14,117,6,43,8,74,15,7,2014
1385,San Francisco,Denver,10/19/2014,John Parry,14,137,6,62,8,75,17,7,2014
1386,Houston,Pittsburgh,10/20/2014,Walt Coleman,10,58,4,20,6,38,11,7,2014
1387,San Diego,Denver,10/23/2014,Terry McAulay,16,148,7,77,9,71,17,8,2014
1388,Detroit,Atlanta,10/26/2014,Pete Morelli,13,124,8,85,5,39,17,8,2014
1389,Seattle,Carolina,10/26/2014,Walt Coleman,11,61,7,41,4,20,11,8,2014
1390,Baltimore,Cincinnati,10/26/2014,Clete Blakeman,13,91,7,51,6,40,14,8,2014
1391,Miami,Jacksonville,10/26/2014,Jerome Boger,13,89,7,52,6,37,19,8,2014
1392,St. Louis,Kansas City,10/26/2014,Jeff Triplette,15,119,8,68,7,51,16,8,2014
1393,Chicago,New England,10/26/2014,Brad Allen,12,79,5,41,7,38,13,8,2014
1394,Buffalo,N.Y. Jets,10/26/2014,Gene Steratore,17,139,7,49,10,90,19,8,2014
1395,Minnesota,Tampa Bay,10/26/2014,Craig Wrolstad,14,111,6,59,8,52,20,8,2014
1396,Houston,Tennessee,10/26/2014,Bill Leavy,10,96,4,35,6,61,11,8,2014
1397,Philadelphia,Arizona,10/26/2014,Walt Anderson,21,198,11,103,10,95,24,8,2014
1398,Oakland,Cleveland,10/26/2014,Ron Torbert,14,84,8,54,6,30,18,8,2014
1399,Indianapolis,Pittsburgh,10/26/2014,John Parry,15,102,5,43,10,59,23,8,2014
1400,Green Bay,New Orleans,10/26/2014,Ed Hochuli,12,119,8,84,4,35,14,8,2014
1401,Washington,Dallas,10/27/2014,Tony Corrente,9,80,6,45,3,35,11,8,2014
1402,New Orleans,Carolina,10/30/2014,Clete Blakeman,10,103,4,36,6,67,10,9,2014
1403,Jacksonville,Cincinnati,11/2/2014,Ron Torbert,9,75,3,35,6,40,10,9,2014
1404,Tampa Bay,Cleveland,11/2/2014,Terry McAulay,11,77,4,33,7,44,15,9,2014
1405,Arizona,Dallas,11/2/2014,Craig Wrolstad,11,95,6,62,5,33,13,9,2014
1406,Philadelphia,Houston,11/2/2014,John Parry,16,109,7,55,9,54,18,9,2014
1407,N.Y. Jets,Kansas City,11/2/2014,Tony Corrente,8,60,5,40,3,20,9,9,2014
1408,San Diego,Miami,11/2/2014,Brad Allen,10,82,7,57,3,25,11,9,2014
1409,Washington,Minnesota,11/2/2014,Gene Steratore,15,115,6,55,9,60,18,9,2014
1410,St. Louis,San Francisco,11/2/2014,Jerome Boger,18,127,9,83,9,44,22,9,2014
1411,Denver,New England,11/2/2014,Walt Anderson,19,143,10,72,9,71,20,9,2014
1412,Oakland,Seattle,11/2/2014,Ed Hochuli,14,134,5,69,9,65,14,9,2014
1413,Baltimore,Pittsburgh,11/2/2014,Bill Vinovich,17,175,10,108,7,67,19,9,2014
1414,Indianapolis,N.Y. Giants,11/3/2014,Carl Cheffers,8,60,4,30,4,30,11,9,2014
1415,Cleveland,Cincinnati,11/6/2014,Jeff Triplette,13,117,6,62,7,55,16,10,2014
1416,Tennessee,Baltimore,11/9/2014,Walt Coleman,14,107,9,67,5,40,17,10,2014
1417,Kansas City,Buffalo,11/9/2014,Brad Allen,9,63,3,19,6,44,10,10,2014
1418,Miami,Detroit,11/9/2014,Bill Leavy,15,142,5,44,10,98,20,10,2014
1419,Dallas,Jacksonville,11/9/2014,John Parry,11,84,9,65,2,19,14,10,2014
1420,San Francisco,New Orleans,11/9/2014,Bill Vinovich,8,58,2,15,6,43,9,10,2014
1421,Pittsburgh,N.Y. Jets,11/9/2014,Terry McAulay,12,95,3,20,9,75,13,10,2014
1422,Atlanta,Tampa Bay,11/9/2014,Clete Blakeman,15,109,5,30,10,79,18,10,2014
1423,Denver,Oakland,11/9/2014,Carl Cheffers,16,132,12,95,4,37,18,10,2014
1424,St. Louis,Arizona,11/9/2014,Ron Torbert,13,115,8,80,5,35,15,10,2014
1425,N.Y. Giants,Seattle,11/9/2014,Pete Morelli,10,85,4,35,6,50,12,10,2014
1426,Chicago,Green Bay,11/9/2014,Craig Wrolstad,16,213,11,163,5,50,17,10,2014
1427,Carolina,Philadelphia,11/10/2014,Gene Steratore,9,80,4,30,5,50,9,10,2014
1428,Buffalo,Miami,11/13/2014,Walt Coleman,11,100,7,70,4,30,15,11,2014
1429,Atlanta,Carolina,11/16/2014,Walt Anderson,6,73,5,58,1,15,6,11,2014
1430,Minnesota,Chicago,11/16/2014,Ron Torbert,9,78,2,18,7,60,11,11,2014
1431,Houston,Cleveland,11/16/2014,Ed Hochuli,13,122,5,55,8,67,18,11,2014
1432,Philadelphia,Green Bay,11/16/2014,Carl Cheffers,10,105,6,53,4,52,14,11,2014
1433,Seattle,Kansas City,11/16/2014,Bill Leavy,11,56,8,50,3,6,15,11,2014
1434,Cincinnati,New Orleans,11/16/2014,Craig Wrolstad,9,67,4,33,5,34,11,11,2014
1435,San Francisco,N.Y. Giants,11/16/2014,Gene Steratore,7,89,4,35,3,54,11,11,2014
1436,Denver,St. Louis,11/16/2014,Tony Corrente,11,87,8,62,3,25,12,11,2014
1437,Tampa Bay,Washington,11/16/2014,Bill Vinovich,20,168,11,101,9,67,22,11,2014
1438,Oakland,San Diego,11/16/2014,Jeff Triplette,14,81,8,41,6,40,21,11,2014
1439,Detroit,Arizona,11/16/2014,Jerome Boger,13,115,9,80,4,35,16,11,2014
1440,New England,Indianapolis,11/16/2014,Pete Morelli,9,82,5,53,4,29,14,11,2014
1441,Pittsburgh,Tennessee,11/17/2014,Brad Allen,5,49,4,39,1,10,5,11,2014
1442,Kansas City,Oakland,11/20/2014,John Parry,14,119,7,59,7,60,17,12,2014
1443,Cleveland,Atlanta,11/23/2014,Brad Allen,12,70,5,30,7,40,12,12,2014
1444,N.Y. Jets,Buffalo,11/24/2014,Pete Morelli,13,84,9,60,4,24,15,12,2014
1445,Tampa Bay,Chicago,11/23/2014,Walt Coleman,15,132,9,87,6,45,20,12,2014
1446,Cincinnati,Houston,11/23/2014,Terry McAulay,9,75,6,60,3,15,12,12,2014
1447,Jacksonville,Indianapolis,11/23/2014,Ed Hochuli,12,97,6,43,6,54,18,12,2014
1448,Green Bay,Minnesota,11/23/2014,Clete Blakeman,15,152,8,75,7,77,18,12,2014
1449,Detroit,New England,11/23/2014,Tony Corrente,20,138,9,54,11,84,24,12,2014
1450,Tennessee,Philadelphia,11/23/2014,Jerome Boger,16,125,7,56,9,69,20,12,2014
1451,St. Louis,San Diego,11/23/2014,Carl Cheffers,17,175,9,90,8,85,21,12,2014
1452,Arizona,Seattle,11/23/2014,Gene Steratore,10,99,3,25,7,74,11,12,2014
1453,Miami,Denver,11/23/2014,Jeff Triplette,15,148,6,50,9,98,17,12,2014
1454,Washington,San Francisco,11/23/2014,Walt Anderson,12,100,7,53,5,47,13,12,2014
1455,Dallas,N.Y. Giants,11/23/2014,Bill Vinovich,12,93,7,63,5,30,14,12,2014
1456,Baltimore,New Orleans,11/24/2014,Bill Leavy,11,92,6,42,5,50,14,12,2014
1457,Chicago,Detroit,11/27/2014,Bill Vinovich,10,79,5,41,5,38,12,13,2014
1458,Philadelphia,Dallas,11/27/2014,Clete Blakeman,10,62,4,20,6,42,10,13,2014
1459,Seattle,San Francisco,11/27/2014,Tony Corrente,17,125,14,105,3,20,21,13,2014
1460,San Diego,Baltimore,11/30/2014,Walt Anderson,22,189,8,91,14,98,27,13,2014
1461,Cleveland,Buffalo,11/30/2014,Jerome Boger,16,121,10,76,6,45,21,13,2014
1462,Tennessee,Houston,11/30/2014,Jeff Triplette,11,106,6,66,5,40,17,13,2014
1463,Washington,Indianapolis,11/30/2014,John Parry,20,172,10,78,10,94,24,13,2014
1464,N.Y. Giants,Jacksonville,11/30/2014,Craig Wrolstad,13,89,6,40,7,49,14,13,2014
1465,Carolina,Minnesota,11/30/2014,Brad Allen,9,60,4,35,5,25,10,13,2014
1466,New Orleans,Pittsburgh,11/30/2014,Pete Morelli,16,105,11,77,5,28,17,13,2014
1467,Oakland,St. Louis,11/30/2014,Gene Steratore,16,133,8,73,8,60,17,13,2014
1468,Cincinnati,Tampa Bay,11/30/2014,Bill Leavy,23,167,10,73,13,94,26,13,2014
1469,Arizona,Atlanta,11/30/2014,Terry McAulay,14,110,5,34,9,76,19,13,2014
1470,New England,Green Bay,11/30/2014,Ed Hochuli,8,47,4,25,4,22,9,13,2014
1471,Denver,Kansas City,11/30/2014,Walt Coleman,10,67,5,32,5,35,11,13,2014
1472,Miami,N.Y. Jets,12/1/2014,Ron Torbert,10,77,3,20,7,57,12,13,2014
1473,Dallas,Chicago,12/4/2014,Ed Hochuli,17,151,8,97,9,54,18,14,2014
1474,Pittsburgh,Cincinnati,12/7/2014,Tony Corrente,10,74,3,20,7,54,11,14,2014
1475,Indianapolis,Cleveland,12/7/2014,Clete Blakeman,13,125,6,40,7,85,16,14,2014
1476,Tampa Bay,Detroit,12/7/2014,Jeff Triplette,14,172,5,50,9,122,15,14,2014
1477,Houston,Jacksonville,12/7/2014,Carl Cheffers,13,104,7,64,6,40,16,14,2014
1478,Baltimore,Miami,12/7/2014,John Parry,13,66,7,36,6,30,15,14,2014
1479,N.Y. Jets,Minnesota,12/7/2014,Jerome Boger,10,110,4,40,6,70,15,14,2014
1480,Carolina,New Orleans,12/7/2014,Walt Coleman,10,85,6,55,4,30,14,14,2014
1481,N.Y. Giants,Tennessee,12/7/2014,Walt Anderson,12,109,7,70,5,39,15,14,2014
1482,St. Louis,Washington,12/7/2014,Brad Allen,16,149,11,98,5,51,17,14,2014
1483,Kansas City,Arizona,12/7/2014,Craig Wrolstad,15,115,9,75,6,40,19,14,2014
1484,Buffalo,Denver,12/7/2014,Ron Torbert,16,143,11,98,5,45,21,14,2014
1485,San Francisco,Oakland,12/7/2014,Terry McAulay,17,134,7,50,10,84,17,14,2014
1486,Seattle,Philadelphia,12/7/2014,Bill Vinovich,12,136,8,67,4,69,13,14,2014
1487,New England,San Diego,12/7/2014,Bill Leavy,14,131,6,70,8,61,14,14,2014
1488,Atlanta,Green Bay,12/8/2014,Pete Morelli,8,51,3,11,5,40,10,14,2014
1489,Arizona,St. Louis,12/11/2014,Walt Coleman,14,128,8,59,6,69,15,15,2014
1490,Pittsburgh,Atlanta,12/14/2014,Clete Blakeman,6,59,3,34,3,25,8,15,2014
1491,Jacksonville,Baltimore,12/14/2014,Tony Corrente,14,130,5,60,9,70,17,15,2014
1492,Green Bay,Buffalo,12/14/2014,Bill Leavy,19,145,9,70,10,75,21,15,2014
1493,Tampa Bay,Carolina,12/14/2014,Ron Torbert,8,54,4,29,4,25,9,15,2014
1494,Cincinnati,Cleveland,12/14/2014,Walt Anderson,14,109,5,41,9,68,17,15,2014
1495,Minnesota,Detroit,12/14/2014,Pete Morelli,8,60,3,25,5,35,8,15,2014
1496,Houston,Indianapolis,12/14/2014,Gene Steratore,15,111,8,66,7,45,17,15,2014
1497,Oakland,Kansas City,12/14/2014,Jerome Boger,21,159,10,75,11,84,26,15,2014
1498,Miami,New England,12/14/2014,Bill Vinovich,10,86,5,35,5,51,13,15,2014
1499,Washington,N.Y. Giants,12/14/2014,Jeff Triplette,19,195,10,135,9,60,22,15,2014
1500,Denver,San Diego,12/14/2014,Craig Wrolstad,15,136,7,71,8,65,19,15,2014
1501,N.Y. Jets,Tennessee,12/14/2014,John Parry,16,122,7,46,9,76,18,15,2014
1502,San Francisco,Seattle,12/14/2014,Ed Hochuli,15,128,8,78,7,50,16,15,2014
1503,Dallas,Philadelphia,12/14/2014,Terry McAulay,19,174,11,79,8,95,24,15,2014
1504,New Orleans,Chicago,12/15/2014,Carl Cheffers,12,99,3,25,9,74,19,15,2014
1505,Tennessee,Jacksonville,12/18/2014,Clete Blakeman,10,72,7,47,3,25,12,16,2014
1506,Philadelphia,Washington,12/20/2014,Carl Cheffers,16,117,13,102,3,15,20,16,2014
1507,San Diego,San Francisco,12/20/2014,Jeff Triplette,17,130,8,38,9,92,30,16,2014
1508,Cleveland,Carolina,12/21/2014,Ed Hochuli,11,98,6,49,5,49,11,16,2014
1509,Detroit,Chicago,12/21/2014,Gene Steratore,12,146,7,60,5,86,14,16,2014
1510,Baltimore,Houston,12/21/2014,Walt Coleman,14,125,7,56,7,69,19,16,2014
1511,Minnesota,Miami,12/21/2014,Tony Corrente,15,128,8,74,7,54,23,16,2014
1512,Atlanta,New Orleans,12/21/2014,John Parry,9,89,6,64,3,25,10,16,2014
1513,New England,N.Y. Jets,12/21/2014,Brad Allen,7,52,5,38,2,14,8,16,2014
1514,Kansas City,Pittsburgh,12/21/2014,Ron Torbert,8,79,4,39,4,40,13,16,2014
1515,Green Bay,Tampa Bay,12/21/2014,Terry McAulay,8,70,5,40,3,30,9,16,2014
1516,N.Y. Giants,St. Louis,12/21/2014,Pete Morelli,21,225,12,149,9,76,30,16,2014
1517,Indianapolis,Dallas,12/21/2014,Bill Leavy,15,122,8,55,7,67,19,16,2014
1518,Buffalo,Oakland,12/21/2014,Craig Wrolstad,11,90,7,55,4,35,11,16,2014
1519,Seattle,Arizona,12/21/2014,Walt Anderson,12,102,11,97,1,5,16,16,2014
1520,Denver,Cincinnati,12/22/2014,Bill Vinovich,13,117,6,72,7,45,16,16,2014
1521,Carolina,Atlanta,12/28/2014,Bill Leavy,11,72,5,36,6,36,14,17,2014
1522,Cleveland,Baltimore,12/28/2014,Gene Steratore,15,113,7,58,8,55,19,17,2014
1523,Detroit,Green Bay,12/28/2014,Walt Anderson,15,93,10,53,5,40,16,17,2014
1524,Jacksonville,Houston,12/28/2014,John Parry,10,80,4,25,6,55,15,17,2014
1525,San Diego,Kansas City,12/28/2014,Pete Morelli,17,113,10,67,7,46,18,17,2014
1526,N.Y. Jets,Miami,12/28/2014,Craig Wrolstad,10,80,5,40,5,40,16,17,2014
1527,Chicago,Minnesota,12/28/2014,Jeff Triplette,12,75,8,50,4,25,14,17,2014
1528,Buffalo,New England,12/28/2014,Terry McAulay,10,99,5,44,5,55,12,17,2014
1529,Philadelphia,N.Y. Giants,12/28/2014,Walt Coleman,13,141,5,35,8,106,15,17,2014
1530,Cincinnati,Pittsburgh,12/28/2014,Ed Hochuli,6,55,5,45,1,10,9,17,2014
1531,New Orleans,Tampa Bay,12/28/2014,Brad Allen,6,38,2,15,4,23,8,17,2014
1532,Indianapolis,Tennessee,12/28/2014,Tony Corrente,8,40,4,20,4,20,9,17,2014
1533,Dallas,Washington,12/28/2014,Jerome Boger,16,149,7,48,9,101,16,17,2014
1534,Oakland,Denver,12/28/2014,Clete Blakeman,10,102,9,86,1,16,11,17,2014
1535,Arizona,San Francisco,12/28/2014,Carl Cheffers,13,99,3,21,10,78,17,17,2014
1536,St. Louis,Seattle,12/28/2014,Ron Torbert,8,65,6,45,2,20,11,17,2014
1537,Pittsburgh,New England,9/10/2015,Carl Cheffers,15,141,8,77,7,64,16,1,2015
1538,Green Bay,Chicago,9/13/2015,Craig Wrolstad,16,138,10,74,6,64,20,1,2015
1539,Seattle,St. Louis,9/13/2015,Jeff Triplette,11,76,7,46,4,30,15,1,2015
1540,Carolina,Jacksonville,9/13/2015,Ron Torbert,6,47,3,22,3,25,8,1,2015
1541,Miami,Washington,9/13/2015,Walt Coleman,17,127,6,39,11,88,21,1,2015
1542,Indianapolis,Buffalo,9/13/2015,John Parry,16,162,5,49,11,113,18,1,2015
1543,Cleveland,N.Y. Jets,9/13/2015,Jerome Boger,16,139,12,109,4,30,17,1,2015
1544,Kansas City,Houston,9/13/2015,Pete Morelli,8,64,2,25,6,39,9,1,2015
1545,New Orleans,Arizona,9/13/2015,Walt Anderson,12,103,7,73,5,30,15,1,2015
1546,Detroit,San Diego,9/13/2015,Clete Blakeman,9,69,4,29,5,40,9,1,2015
1547,Baltimore,Denver,9/13/2015,Gene Steratore,11,60,3,15,8,45,11,1,2015
1548,Cincinnati,Oakland,9/13/2015,Brad Allen,11,82,6,50,5,32,15,1,2015
1549,Tennessee,Tampa Bay,9/13/2015,John Hussey,20,152,8,55,12,97,25,1,2015
1550,N.Y. Giants,Dallas,9/13/2015,Bill Vinovich,8,79,5,44,3,35,10,1,2015
1551,Philadelphia,Atlanta,9/14/2015,Terry McAulay,17,145,10,88,7,57,22,1,2015
1552,Minnesota,San Francisco,9/14/2015,Ed Hochuli,13,82,5,25,8,57,16,1,2015
1553,Denver,Kansas City,9/17/2015,Walt Anderson,17,145,8,85,9,60,21,2,2015
1554,Houston,Carolina,9/20/2015,Clete Blakeman,20,162,10,70,10,92,21,2,2015
1555,New England,Buffalo,9/20/2015,Ron Torbert,25,259,11,119,14,140,31,2,2015
1556,San Diego,Cincinnati,9/20/2015,Jeff Triplette,17,139,8,64,9,75,23,2,2015
1557,Tennessee,Cleveland,9/20/2015,Terry McAulay,13,125,9,85,4,40,15,2,2015
1558,Atlanta,N.Y. Giants,9/20/2015,Brad Allen,12,100,6,65,6,35,15,2,2015
1559,St. Louis,Washington,9/20/2015,Ed Hochuli,16,133,9,80,7,53,19,2,2015
1560,Arizona,Chicago,9/20/2015,Jerome Boger,22,228,8,58,14,170,23,2,2015
1561,Detroit,Minnesota,9/20/2015,Bill Vinovich,16,136,6,39,10,97,17,2,2015
1562,Tampa Bay,New Orleans,9/20/2015,Carl Cheffers,21,205,11,90,10,115,24,2,2015
1563,San Francisco,Pittsburgh,9/20/2015,Craig Wrolstad,14,104,7,46,7,58,16,2,2015
1564,Baltimore,Oakland,9/20/2015,Pete Morelli,26,215,10,109,16,106,30,2,2015
1565,Miami,Jacksonville,9/20/2015,John Parry,22,205,13,112,9,93,25,2,2015
1566,Dallas,Philadelphia,9/20/2015,Tony Corrente,26,202,18,142,8,60,31,2,2015
1567,Seattle,Green Bay,9/20/2015,Gene Steratore,12,127,6,92,6,35,22,2,2015
1568,N.Y. Jets,Indianapolis,9/21/2015,John Hussey,19,174,8,90,11,84,23,2,2015
1569,Washington,N.Y. Giants,9/24/2015,Ron Torbert,15,125,7,58,8,67,18,3,2015
1570,Atlanta,Dallas,9/27/2015,Pete Morelli,11,101,6,70,5,31,11,3,2015
1571,New Orleans,Carolina,9/27/2015,Ed Hochuli,18,143,8,55,10,88,19,3,2015
1572,Philadelphia,N.Y. Jets,9/27/2015,Gene Steratore,11,74,5,21,6,53,16,3,2015
1573,Tampa Bay,Houston,9/27/2015,Bill Vinovich,16,142,10,84,6,58,20,3,2015
1574,San Diego,Minnesota,9/27/2015,Terry McAulay,10,113,7,74,3,39,13,3,2015
1575,Pittsburgh,St. Louis,9/27/2015,John Hussey,11,160,4,63,7,97,11,3,2015
1576,Jacksonville,New England,9/27/2015,Walt Coleman,11,144,7,114,4,30,12,3,2015
1577,Cincinnati,Baltimore,9/27/2015,Walt Anderson,22,183,9,67,13,116,27,3,2015
1578,Oakland,Cleveland,9/27/2015,Clete Blakeman,18,135,12,85,6,50,21,3,2015
1579,Indianapolis,Tennessee,9/27/2015,Craig Wrolstad,17,126,11,71,6,55,17,3,2015
1580,San Francisco,Arizona,9/27/2015,Tony Corrente,10,69,6,45,4,24,14,3,2015
1581,Chicago,Seattle,9/27/2015,Carl Cheffers,11,81,6,40,5,41,11,3,2015
1582,Buffalo,Miami,9/27/2015,Jerome Boger,11,76,5,40,6,36,15,3,2015
1583,Denver,Detroit,9/27/2015,Jeff Triplette,18,169,9,94,9,75,19,3,2015
1584,Kansas City,Green Bay,9/28/2015,John Parry,19,127,7,38,12,89,25,3,2015
1585,Baltimore,Pittsburgh,10/1/2015,Clete Blakeman,8,50,4,30,4,20,9,4,2015
1586,N.Y. Jets,Miami,10/4/2015,Craig Wrolstad,23,243,14,163,9,80,25,4,2015
1587,Oakland,Chicago,10/4/2015,Jeff Triplette,12,95,5,47,7,48,14,4,2015
1588,Houston,Atlanta,10/4/2015,Carl Cheffers,15,115,5,35,10,80,18,4,2015
1589,Kansas City,Cincinnati,10/4/2015,Ron Torbert,18,130,7,46,11,84,19,4,2015
1590,Jacksonville,Indianapolis,10/4/2015,Ed Hochuli,17,137,13,92,4,45,22,4,2015
1591,Philadelphia,Washington,10/4/2015,Jerome Boger,18,182,8,72,10,110,23,4,2015
1592,Carolina,Tampa Bay,10/4/2015,Gene Steratore,10,93,5,45,5,48,13,4,2015
1593,N.Y. Giants,Buffalo,10/4/2015,John Hussey,28,220,11,85,17,135,29,4,2015
1594,Cleveland,San Diego,10/4/2015,Bill Vinovich,18,122,12,91,6,31,20,4,2015
1595,Green Bay,San Francisco,10/4/2015,Terry McAulay,12,95,8,65,4,30,13,4,2015
1596,St. Louis,Arizona,10/4/2015,John Parry,10,86,7,66,3,20,12,4,2015
1597,Minnesota,Denver,10/4/2015,Walt Coleman,17,103,9,63,8,40,19,4,2015
1598,Dallas,New Orleans,10/4/2015,Brad Allen,14,94,6,30,8,64,15,4,2015
1599,Detroit,Seattle,10/5/2015,Tony Corrente,9,67,4,37,5,30,10,4,2015
1600,Indianapolis,Houston,10/8/2015,Terry McAulay,20,190,7,65,13,125,22,5,2015
1601,New Orleans,Philadelphia,10/11/2015,Ron Torbert,11,113,7,78,4,35,13,5,2015
1602,Chicago,Kansas City,10/11/2015,Tony Corrente,9,98,6,49,3,49,13,5,2015
1603,Seattle,Cincinnati,10/11/2015,John Parry,17,162,10,112,7,50,17,5,2015
1604,Washington,Atlanta,10/11/2015,Bill Vinovich,9,113,5,51,4,62,12,5,2015
1605,Jacksonville,Tampa Bay,10/11/2015,Jerome Boger,13,84,3,12,10,72,17,5,2015
1606,Cleveland,Baltimore,10/11/2015,Jeff Triplette,21,172,9,74,12,98,23,5,2015
1607,Buffalo,Tennessee,10/11/2015,Walt Anderson,16,136,7,62,9,74,21,5,2015
1608,St. Louis,Green Bay,10/11/2015,Brad Allen,15,107,8,40,7,67,17,5,2015
1609,Arizona,Detroit,10/11/2015,Gene Steratore,18,155,9,70,9,85,21,5,2015
1610,New England,Dallas,10/11/2015,Clete Blakeman,16,115,9,65,7,50,18,5,2015
1611,Denver,Oakland,10/11/2015,John Hussey,12,144,6,103,6,41,13,5,2015
1612,San Francisco,N.Y. Giants,10/11/2015,Walt Coleman,10,93,4,28,6,65,10,5,2015
1613,Pittsburgh,San Diego,10/12/2015,Pete Morelli,15,140,8,86,7,54,18,5,2015
1614,Atlanta,New Orleans,10/15/2015,Gene Steratore,10,56,7,41,3,15,10,6,2015
1615,Chicago,Detroit,10/18/2015,Walt Coleman,19,174,9,76,10,98,20,6,2015
1616,Washington,N.Y. Jets,10/18/2015,Pete Morelli,4,20,3,15,1,5,7,6,2015
1617,Arizona,Pittsburgh,10/18/2015,Ed Hochuli,15,159,9,111,6,48,18,6,2015
1618,Kansas City,Minnesota,10/18/2015,Jerome Boger,13,145,8,95,5,50,18,6,2015
1619,Cincinnati,Buffalo,10/18/2015,Clete Blakeman,11,113,3,20,8,93,11,6,2015
1620,Denver,Cleveland,10/18/2015,Craig Wrolstad,14,111,8,81,6,30,16,6,2015
1621,Miami,Tennessee,10/18/2015,Jeff Triplette,16,147,9,97,7,50,17,6,2015
1622,Houston,Jacksonville,10/18/2015,Brad Allen,17,133,10,69,7,64,20,6,2015
1623,Carolina,Seattle,10/18/2015,Terry McAulay,12,73,5,25,7,48,13,6,2015
1624,San Diego,Green Bay,10/18/2015,Walt Anderson,15,126,9,76,6,50,21,6,2015
1625,Baltimore,San Francisco,10/18/2015,John Parry,7,40,3,15,4,25,9,6,2015
1626,New England,Indianapolis,10/18/2015,Tony Corrente,19,175,8,72,11,103,22,6,2015
1627,N.Y. Giants,Philadelphia,10/19/2015,Carl Cheffers,21,164,12,92,9,72,24,6,2015
1628,Seattle,San Francisco,10/22/2015,Walt Anderson,10,83,6,50,4,33,12,7,2015
1629,Buffalo,Jacksonville,10/25/2015,Terry McAulay,20,153,10,87,10,66,24,7,2015
1630,Cleveland,St. Louis,10/25/2015,Pete Morelli,20,173,11,98,9,75,23,7,2015
1631,Houston,Miami,10/25/2015,John Hussey,11,77,3,25,8,52,19,7,2015
1632,N.Y. Jets,New England,10/25/2015,Bill Vinovich,8,67,4,29,4,38,11,7,2015
1633,Pittsburgh,Kansas City,10/25/2015,Walt Coleman,7,71,1,5,6,66,7,7,2015
1634,Tampa Bay,Washington,10/25/2015,Jeff Triplette,20,162,16,142,4,20,22,7,2015
1635,Minnesota,Detroit,10/25/2015,Ed Hochuli,8,61,3,31,5,30,9,7,2015
1636,New Orleans,Indianapolis,10/25/2015,Carl Cheffers,19,142,12,100,7,42,25,7,2015
1637,Atlanta,Tennessee,10/25/2015,Brad Allen,11,98,6,53,5,45,11,7,2015
1638,Oakland,San Diego,10/25/2015,Jerome Boger,23,222,14,136,9,86,26,7,2015
1639,Dallas,N.Y. Giants,10/25/2015,John Parry,10,59,7,46,3,13,10,7,2015
1640,Philadelphia,Carolina,10/25/2015,Craig Wrolstad,12,89,7,46,5,43,14,7,2015
1641,Baltimore,Arizona,10/26/2015,Ron Torbert,13,104,9,64,4,40,16,7,2015
1642,Miami,New England,10/29/2015,Pete Morelli,15,109,7,40,8,69,16,8,2015
1643,Detroit,Kansas City,11/1/2015,Jeff Triplette,11,101,8,81,3,20,12,8,2015
1644,San Diego,Baltimore,11/1/2015,Gene Steratore,11,112,6,66,5,46,13,8,2015
1645,Cincinnati,Pittsburgh,11/1/2015,Tony Corrente,20,185,10,94,10,91,27,8,2015
1646,Tennessee,Houston,11/1/2015,Clete Blakeman,13,130,6,45,7,85,16,8,2015
1647,Minnesota,Chicago,11/1/2015,John Hussey,8,73,4,35,4,38,8,8,2015
1648,Tampa Bay,Atlanta,11/1/2015,Ron Torbert,19,167,8,43,11,124,23,8,2015
1649,N.Y. Giants,New Orleans,11/1/2015,Craig Wrolstad,18,146,6,53,12,93,21,8,2015
1650,San Francisco,St. Louis,11/1/2015,Jerome Boger,25,186,13,93,12,93,28,8,2015
1651,Arizona,Cleveland,11/1/2015,Walt Coleman,12,60,5,25,7,35,16,8,2015
1652,N.Y. Jets,Oakland,11/1/2015,Ed Hochuli,12,101,6,40,6,61,16,8,2015
1653,Seattle,Dallas,11/1/2015,Carl Cheffers,10,80,5,40,5,40,11,8,2015
1654,Green Bay,Denver,11/1/2015,John Parry,13,108,2,15,11,93,17,8,2015
1655,Indianapolis,Carolina,11/2/2015,Bill Vinovich,8,70,2,15,6,55,8,8,2015
1656,Cleveland,Cincinnati,11/5/2015,Carl Cheffers,6,48,4,28,2,20,8,9,2015
1657,St. Louis,Minnesota,11/8/2015,Ron Torbert,18,154,12,87,6,67,20,9,2015
1658,Green Bay,Carolina,11/8/2015,Gene Steratore,13,132,7,87,6,45,16,9,2015
1659,Washington,New England,11/8/2015,Terry McAulay,10,70,4,27,6,43,11,9,2015
1660,Tennessee,New Orleans,11/8/2015,Jerome Boger,17,141,9,66,8,75,20,9,2015
1661,Miami,Buffalo,11/8/2015,Carl Cheffers,21,156,8,62,13,94,25,9,2015
1662,Jacksonville,N.Y. Jets,11/8/2015,Walt Coleman,10,71,4,30,6,41,12,9,2015
1663,Oakland,Pittsburgh,11/8/2015,Bill Vinovich,8,63,3,21,5,42,11,9,2015
1664,N.Y. Giants,Tampa Bay,11/8/2015,Clete Blakeman,15,128,6,49,9,79,18,9,2015
1665,Atlanta,San Francisco,11/8/2015,Tony Corrente,11,93,6,63,5,30,12,9,2015
1666,Denver,Indianapolis,11/8/2015,Brad Allen,12,86,8,56,4,30,13,9,2015
1667,Philadelphia,Dallas,11/8/2015,Ed Hochuli,18,128,10,70,8,58,20,9,2015
1668,Chicago,San Diego,11/9/2015,Craig Wrolstad,14,109,6,55,8,54,14,9,2015
1669,Buffalo,N.Y. Jets,11/12/2015,Brad Allen,8,64,5,44,3,20,9,10,2015
1670,New Orleans,Washington,11/15/2015,John Parry,12,76,7,50,5,26,13,10,2015
1671,Detroit,Green Bay,11/15/2015,John Hussey,8,90,3,35,5,55,9,10,2015
1672,Dallas,Tampa Bay,11/15/2015,Bill Vinovich,13,130,6,68,7,62,14,10,2015
1673,Carolina,Tennessee,11/15/2015,Walt Anderson,9,75,5,45,4,30,9,10,2015
1674,Chicago,St. Louis,11/15/2015,Jeff Triplette,12,101,4,44,8,57,14,10,2015
1675,Miami,Philadelphia,11/15/2015,Terry McAulay,15,138,8,84,7,54,22,10,2015
1676,Jacksonville,Baltimore,11/15/2015,Pete Morelli,13,151,4,30,9,121,15,10,2015
1677,Cleveland,Pittsburgh,11/15/2015,Ron Torbert,17,238,12,188,5,50,24,10,2015
1678,Minnesota,Oakland,11/15/2015,Tony Corrente,11,97,3,15,8,82,14,10,2015
1679,New England,N.Y. Giants,11/15/2015,Ed Hochuli,15,142,7,93,8,49,18,10,2015
1680,Kansas City,Denver,11/15/2015,Gene Steratore,16,157,11,102,5,55,18,10,2015
1681,Arizona,Seattle,11/15/2015,Clete Blakeman,23,202,9,71,14,131,25,10,2015
1682,Houston,Cincinnati,11/16/2015,Walt Coleman,14,124,5,54,9,70,16,10,2015
1683,Tennessee,Jacksonville,11/19/2015,Craig Wrolstad,14,147,6,59,8,88,14,11,2015
1684,Denver,Chicago,11/22/2015,Pete Morelli,8,118,8,118,0,0,9,11,2015
1685,Oakland,Detroit,11/22/2015,Clete Blakeman,13,86,6,31,7,55,15,11,2015
1686,Indianapolis,Atlanta,11/22/2015,Walt Anderson,13,111,7,42,6,69,16,11,2015
1687,N.Y. Jets,Houston,11/22/2015,John Parry,10,108,7,54,3,54,14,11,2015
1688,Tampa Bay,Philadelphia,11/22/2015,Brad Allen,14,107,9,82,5,25,19,11,2015
1689,Green Bay,Minnesota,11/22/2015,Walt Coleman,12,129,4,19,8,110,16,11,2015
1690,Washington,Carolina,11/22/2015,Jerome Boger,17,134,9,68,8,66,22,11,2015
1691,Dallas,Miami,11/22/2015,Jeff Triplette,19,153,10,79,9,74,22,11,2015
1692,St. Louis,Baltimore,11/22/2015,Tony Corrente,16,172,6,35,10,137,22,11,2015
1693,Cincinnati,Arizona,11/22/2015,Terry McAulay,17,148,10,108,7,40,19,11,2015
1694,San Francisco,Seattle,11/22/2015,Ed Hochuli,13,93,5,42,8,51,16,11,2015
1695,Kansas City,San Diego,11/22/2015,Carl Cheffers,11,74,5,35,6,39,13,11,2015
1696,Buffalo,New England,11/23/2015,Gene Steratore,10,105,5,44,5,61,14,11,2015
1697,Philadelphia,Detroit,11/26/2015,John Parry,6,59,2,30,4,29,9,12,2015
1698,Carolina,Dallas,11/26/2015,Ron Torbert,13,93,8,53,5,40,13,12,2015
1699,Chicago,Green Bay,11/26/2015,Ed Hochuli,15,133,12,95,3,38,17,12,2015
1700,N.Y. Giants,Washington,11/29/2015,Carl Cheffers,11,115,4,35,7,80,18,12,2015
1701,Minnesota,Atlanta,11/29/2015,Clete Blakeman,15,131,9,53,6,78,16,12,2015
1702,St. Louis,Cincinnati,11/29/2015,Craig Wrolstad,10,80,7,45,3,35,14,12,2015
1703,New Orleans,Houston,11/29/2015,John Hussey,16,122,10,82,6,40,16,12,2015
1704,Tampa Bay,Indianapolis,11/29/2015,Walt Coleman,18,140,12,95,6,45,20,12,2015
1705,Miami,N.Y. Jets,11/29/2015,Bill Vinovich,12,85,6,45,6,40,16,12,2015
1706,San Diego,Jacksonville,11/29/2015,Jerome Boger,14,105,8,70,6,35,15,12,2015
1707,Oakland,Tennessee,11/29/2015,Jeff Triplette,15,119,11,94,4,25,20,12,2015
1708,Buffalo,Kansas City,11/29/2015,Terry McAulay,17,149,9,91,8,58,18,12,2015
1709,Arizona,San Francisco,11/29/2015,Pete Morelli,20,128,7,47,13,81,21,12,2015
1710,Pittsburgh,Seattle,11/29/2015,Walt Anderson,14,141,6,65,8,76,16,12,2015
1711,New England,Denver,11/29/2015,Tony Corrente,11,93,5,47,6,46,11,12,2015
1712,Baltimore,Cleveland,11/30/2015,Brad Allen,9,65,7,50,2,15,9,12,2015
1713,Green Bay,Detroit,12/3/2015,Carl Cheffers,16,163,7,55,9,108,17,13,2015
1714,N.Y. Jets,N.Y. Giants,12/6/2015,John Hussey,16,121,8,61,8,60,17,13,2015
1715,Houston,Buffalo,12/6/2015,Tony Corrente,15,131,10,89,5,42,18,13,2015
1716,Baltimore,Miami,12/6/2015,John Parry,10,67,5,36,5,31,12,13,2015
1717,Cincinnati,Cleveland,12/6/2015,Jeff Triplette,12,139,5,55,7,84,13,13,2015
1718,Jacksonville,Tennessee,12/6/2015,Gene Steratore,10,59,6,21,4,38,10,13,2015
1719,San Francisco,Chicago,12/6/2015,Jerome Boger,14,122,6,50,8,72,15,13,2015
1720,Seattle,Minnesota,12/6/2015,Terry McAulay,18,160,9,65,9,95,20,13,2015
1721,Carolina,New Orleans,12/6/2015,Brad Allen,19,191,8,87,11,104,19,13,2015
1722,Atlanta,Tampa Bay,12/6/2015,Ed Hochuli,15,111,7,58,8,53,15,13,2015
1723,Arizona,St. Louis,12/6/2015,Bill Vinovich,10,129,3,25,7,104,11,13,2015
1724,Kansas City,Oakland,12/6/2015,Craig Wrolstad,15,109,11,88,4,21,15,13,2015
1725,Denver,San Diego,12/6/2015,Walt Coleman,11,90,3,18,8,72,13,13,2015
1726,Philadelphia,New England,12/6/2015,Ron Torbert,11,127,8,97,3,30,16,13,2015
1727,Indianapolis,Pittsburgh,12/6/2015,Pete Morelli,9,78,5,30,4,48,10,13,2015
1728,Dallas,Washington,12/7/2015,Walt Anderson,17,144,8,70,9,74,19,13,2015
1729,Minnesota,Arizona,12/10/2015,Gene Steratore,7,55,3,25,4,30,12,14,2015
1730,Buffalo,Philadelphia,12/13/2015,Ed Hochuli,20,156,15,101,5,55,23,14,2015
1731,Tennessee,N.Y. Jets,12/13/2015,Jerome Boger,6,40,3,20,3,20,10,14,2015
1732,Pittsburgh,Cincinnati,12/13/2015,John Parry,9,109,5,82,4,27,12,14,2015
1733,New England,Houston,12/13/2015,Jeff Triplette,10,82,6,46,4,36,11,14,2015
1734,Indianapolis,Jacksonville,12/13/2015,Carl Cheffers,13,125,8,85,5,40,18,14,2015
1735,San Diego,Kansas City,12/13/2015,Pete Morelli,15,101,7,48,8,53,18,14,2015
1736,Washington,Chicago,12/13/2015,Ron Torbert,15,142,8,63,7,79,16,14,2015
1737,Atlanta,Carolina,12/13/2015,Tony Corrente,12,114,6,54,6,60,19,14,2015
1738,New Orleans,Tampa Bay,12/13/2015,Clete Blakeman,20,175,12,95,8,80,20,14,2015
1739,Detroit,St. Louis,12/13/2015,Walt Anderson,10,93,5,45,5,48,15,14,2015
1740,San Francisco,Cleveland,12/13/2015,John Hussey,13,111,5,40,8,71,15,14,2015
1741,Oakland,Denver,12/13/2015,Bill Vinovich,14,97,10,70,4,27,14,14,2015
1742,Dallas,Green Bay,12/13/2015,Brad Allen,14,99,6,30,8,69,16,14,2015
1743,Seattle,Baltimore,12/13/2015,Walt Coleman,15,136,6,42,9,94,18,14,2015
1744,N.Y. Giants,Miami,12/14/2015,Craig Wrolstad,15,148,3,25,12,123,15,14,2015
1745,Tampa Bay,St. Louis,12/17/2015,Jerome Boger,14,91,9,56,5,35,17,15,2015
1746,N.Y. Jets,Dallas,12/19/2015,Craig Wrolstad,14,115,8,61,6,54,16,15,2015
1747,Carolina,N.Y. Giants,12/20/2015,Terry McAulay,14,135,7,88,7,47,18,15,2015
1748,Arizona,Philadelphia,12/20/2015,Tony Corrente,6,48,1,10,5,38,6,15,2015
1749,Chicago,Minnesota,12/20/2015,Brad Allen,10,84,6,39,4,45,16,15,2015
1750,Atlanta,Jacksonville,12/20/2015,Bill Vinovich,10,105,5,43,5,62,20,15,2015
1751,Houston,Indianapolis,12/20/2015,Ed Hochuli,14,142,6,48,8,94,16,15,2015
1752,Tennessee,New England,12/20/2015,Walt Coleman,8,64,3,29,5,35,12,15,2015
1753,Kansas City,Baltimore,12/20/2015,Jeff Triplette,13,118,6,55,7,63,14,15,2015
1754,Buffalo,Washington,12/20/2015,Clete Blakeman,13,62,8,56,5,6,15,15,2015
1755,Cleveland,Seattle,12/20/2015,Gene Steratore,9,70,4,40,5,30,12,15,2015
1756,Green Bay,Oakland,12/20/2015,Walt Anderson,16,170,6,75,10,95,20,15,2015
1757,Denver,Pittsburgh,12/20/2015,Carl Cheffers,21,190,12,127,9,63,29,15,2015
1758,Miami,San Diego,12/20/2015,John Hussey,16,120,9,72,7,48,20,15,2015
1759,Cincinnati,San Francisco,12/20/2015,Ron Torbert,17,143,6,45,11,98,19,15,2015
1760,Detroit,New Orleans,12/21/2015,Pete Morelli,16,120,10,92,6,28,20,15,2015
1761,San Diego,Oakland,12/24/2015,Carl Cheffers,24,196,9,75,15,121,28,16,2015
1762,Washington,Philadelphia,12/26/2015,Walt Coleman,16,115,8,70,8,45,21,16,2015
1763,Jacksonville,New Orleans,12/27/2015,Ron Torbert,13,95,8,55,5,40,13,16,2015
1764,Indianapolis,Miami,12/27/2015,Gene Steratore,15,110,6,60,9,50,15,16,2015
1765,New England,N.Y. Jets,12/27/2015,Clete Blakeman,7,46,1,7,6,39,8,16,2015
1766,Houston,Tennessee,12/27/2015,Brad Allen,8,71,4,28,4,43,11,16,2015
1767,Cleveland,Kansas City,12/27/2015,Walt Anderson,13,116,8,83,5,33,14,16,2015
1768,San Francisco,Detroit,12/27/2015,Bill Vinovich,18,136,11,65,7,71,21,16,2015
1769,N.Y. Giants,Minnesota,12/27/2015,Tony Corrente,9,58,7,48,2,10,11,16,2015
1770,Carolina,Atlanta,12/27/2015,John Parry,7,60,4,40,3,20,13,16,2015
1771,Chicago,Tampa Bay,12/27/2015,Pete Morelli,7,72,3,25,4,47,8,16,2015
1772,Dallas,Buffalo,12/27/2015,Jeff Triplette,15,127,8,65,7,62,18,16,2015
1773,Green Bay,Arizona,12/27/2015,Terry McAulay,17,178,7,59,10,119,20,16,2015
1774,St. Louis,Seattle,12/27/2015,John Hussey,15,143,5,60,10,83,16,16,2015
1775,Pittsburgh,Baltimore,12/27/2015,Craig Wrolstad,15,146,3,25,12,121,15,16,2015
1776,Cincinnati,Denver,12/28/2015,Ed Hochuli,11,85,6,45,5,40,11,16,2015
1777,N.Y. Jets,Buffalo,1/3/2016,Walt Anderson,10,86,6,41,4,45,10,17,2015
1778,New England,Miami,1/3/2016,Ed Hochuli,17,134,7,41,10,93,20,17,2015
1779,Baltimore,Cincinnati,1/3/2016,Carl Cheffers,15,110,4,38,11,72,20,17,2015
1780,Pittsburgh,Cleveland,1/3/2016,Pete Morelli,17,92,9,45,8,47,20,17,2015
1781,Jacksonville,Houston,1/3/2016,Terry McAulay,16,108,7,53,9,55,18,17,2015
1782,Tennessee,Indianapolis,1/3/2016,Clete Blakeman,12,131,6,60,6,71,13,17,2015
1783,Oakland,Kansas City,1/3/2016,Tony Corrente,12,114,7,59,5,55,13,17,2015
1784,Washington,Dallas,1/3/2016,John Parry,7,64,3,20,4,44,10,17,2015
1785,Philadelphia,N.Y. Giants,1/3/2016,Gene Steratore,5,21,3,11,2,10,7,17,2015
1786,Detroit,Chicago,1/3/2016,John Hussey,5,36,4,21,1,15,6,17,2015
1787,Minnesota,Green Bay,1/3/2016,Bill Vinovich,12,91,5,37,7,54,13,17,2015
1788,New Orleans,Atlanta,1/3/2016,Craig Wrolstad,8,77,4,45,4,32,10,17,2015
1789,Tampa Bay,Carolina,1/3/2016,Jerome Boger,12,98,5,65,7,33,14,17,2015
1790,San Diego,Denver,1/3/2016,Ron Torbert,13,80,7,45,6,35,15,17,2015
1791,Seattle,Arizona,1/3/2016,Brad Allen,12,113,6,70,6,43,12,17,2015
1792,St. Louis,San Francisco,1/3/2016,Walt Coleman,18,165,11,105,7,60,22,17,2015
1793,Carolina,Denver,9/8/2016,Gene Steratore,12,107,8,85,4,22,17,1,2016
1794,Tampa Bay,Atlanta,9/11/2016,Jeff Triplette,13,122,6,48,7,74,17,1,2016
1795,Buffalo,Baltimore,9/11/2016,Brad Allen,14,124,8,89,6,35,16,1,2016
1796,Chicago,Houston,9/11/2016,Pete Morelli,10,99,4,30,6,69,13,1,2016
1797,Green Bay,Jacksonville,9/11/2016,Carl Cheffers,14,103,5,24,9,79,17,1,2016
1798,San Diego,Kansas City,9/11/2016,Jerome Boger,11,76,5,30,6,46,18,1,2016
1799,Oakland,New Orleans,9/11/2016,John Parry,21,194,14,141,7,53,23,1,2016
1800,Cincinnati,N.Y. Jets,9/11/2016,Clete Blakeman,12,139,5,44,7,95,14,1,2016
1801,Cleveland,Philadelphia,9/11/2016,Walt Anderson,11,61,4,15,7,46,12,1,2016
1802,Minnesota,Tennessee,9/11/2016,Walt Coleman,5,49,3,39,2,10,8,1,2016
1803,Miami,Seattle,9/11/2016,John Hussey,12,109,4,40,8,69,13,1,2016
1804,N.Y. Giants,Dallas,9/11/2016,Ron Torbert,10,90,4,40,6,50,13,1,2016
1805,Detroit,Indianapolis,9/11/2016,Ed Hochuli,13,115,8,70,5,45,15,1,2016
1806,New England,Arizona,9/11/2016,Tony Corrente,14,127,8,69,6,58,19,1,2016
1807,Pittsburgh,Washington,9/12/2016,Craig Wrolstad,13,136,4,81,9,55,14,1,2016
1808,LA Rams,San Francisco,9/12/2016,Bill Vinovich,12,112,10,102,2,10,12,1,2016
1809,N.Y. Jets,Buffalo,9/15/2016,Ed Hochuli,13,109,7,50,6,59,14,2,2016
1810,San Francisco,Carolina,9/18/2016,John Parry,14,100,6,50,8,50,18,2,2016
1811,Baltimore,Cleveland,9/18/2016,John Hussey,12,88,4,29,8,59,14,2,2016
1812,Tennessee,Detroit,9/18/2016,Brad Allen,29,221,12,83,17,138,31,2,2016
1813,Kansas City,Houston,9/18/2016,Tony Corrente,14,121,9,77,5,44,17,2,2016
1814,Miami,New England,9/18/2016,Craig Wrolstad,12,114,5,49,7,65,12,2,2016
1815,New Orleans,N.Y. Giants,9/18/2016,Gene Steratore,10,101,7,76,3,25,14,2,2016
1816,Cincinnati,Pittsburgh,9/18/2016,Pete Morelli,10,85,5,31,5,54,13,2,2016
1817,Dallas,Washington,9/18/2016,Bill Vinovich,14,90,6,39,8,51,16,2,2016
1818,Tampa Bay,Arizona,9/18/2016,Ron Torbert,8,69,5,39,3,30,11,2,2016
1819,Seattle,LA Rams,9/18/2016,Jerome Boger,19,192,10,114,9,78,24,2,2016
1820,Indianapolis,Denver,9/18/2016,Walt Coleman,16,148,8,94,8,54,16,2,2016
1821,Atlanta,Oakland,9/18/2016,Clete Blakeman,16,131,7,73,9,58,17,2,2016
1822,Jacksonville,San Diego,9/18/2016,Carl Cheffers,16,116,13,93,3,23,17,2,2016
1823,Green Bay,Minnesota,9/18/2016,Walt Anderson,19,209,6,72,13,137,21,2,2016
1824,Philadelphia,Chicago,9/19/2016,Jeff Triplette,12,94,5,34,7,60,14,2,2016
1825,Houston,New England,9/22/2016,Walt Coleman,9,58,6,43,3,15,10,3,2016
1826,Arizona,Buffalo,9/25/2016,Walt Anderson,17,125,8,50,9,75,21,3,2016
1827,Minnesota,Carolina,9/25/2016,Jerome Boger,16,107,6,42,10,65,20,3,2016
1828,Denver,Cincinnati,9/25/2016,John Parry,14,110,5,41,9,69,20,3,2016
1829,Detroit,Green Bay,9/25/2016,Carl Cheffers,8,131,4,86,4,45,10,3,2016
1830,Baltimore,Jacksonville,9/25/2016,Gene Steratore,15,133,8,58,7,75,19,3,2016
1831,Cleveland,Miami,9/25/2016,Clete Blakeman,21,158,13,91,8,67,23,3,2016
1832,Washington,N.Y. Giants,9/25/2016,John Hussey,19,198,8,70,11,128,26,3,2016
1833,Oakland,Tennessee,9/25/2016,Tony Corrente,16,128,8,58,8,70,18,3,2016
1834,San Francisco,Seattle,9/25/2016,Jeff Triplette,10,85,4,35,6,50,12,3,2016
1835,LA Rams,Tampa Bay,9/25/2016,Ed Hochuli,17,149,8,69,9,80,18,3,2016
1836,Pittsburgh,Philadelphia,9/25/2016,Brad Allen,17,176,7,77,10,99,20,3,2016
1837,San Diego,Indianapolis,9/25/2016,Ron Torbert,21,146,10,80,11,66,22,3,2016
1838,N.Y. Jets,Kansas City,9/25/2016,Bill Vinovich,8,74,3,15,5,59,8,3,2016
1839,Chicago,Dallas,9/25/2016,Craig Wrolstad,10,90,6,45,4,45,12,3,2016
1840,Atlanta,New Orleans,9/26/2016,Pete Morelli,9,110,4,35,5,75,9,3,2016
1841,Miami,Cincinnati,9/29/2016,Bill Vinovich,13,108,7,68,6,40,14,4,2016
1842,Indianapolis,Jacksonville,10/2/2016,Walt Anderson,18,223,7,78,11,145,22,4,2016
1843,Carolina,Atlanta,10/2/2016,John Hussey,14,132,6,55,8,77,18,4,2016
1844,Oakland,Baltimore,10/2/2016,Ed Hochuli,22,198,12,93,10,105,25,4,2016
1845,Detroit,Chicago,10/2/2016,Tony Corrente,18,131,10,76,8,55,22,4,2016
1846,Tennessee,Houston,10/2/2016,Clete Blakeman,17,152,11,93,6,59,19,4,2016
1847,Buffalo,New England,10/2/2016,Pete Morelli,15,134,6,60,9,74,24,4,2016
1848,Seattle,N.Y. Jets,10/2/2016,Carl Cheffers,14,131,7,71,7,60,16,4,2016
1849,Cleveland,Washington,10/2/2016,Jeff Triplette,16,176,7,101,9,75,22,4,2016
1850,Denver,Tampa Bay,10/2/2016,Jerome Boger,18,157,9,88,9,69,19,4,2016
1851,LA Rams,Arizona,10/2/2016,Gene Steratore,15,129,9,84,6,45,18,4,2016
1852,New Orleans,San Diego,10/2/2016,Walt Coleman,11,80,6,34,5,46,13,4,2016
1853,Dallas,San Francisco,10/2/2016,Terry McAulay,11,77,6,45,5,32,11,4,2016
1854,Kansas City,Pittsburgh,10/2/2016,Ron Torbert,16,108,7,40,9,68,17,4,2016
1855,N.Y. Giants,Minnesota,10/3/2016,Brad Allen,14,106,8,69,6,37,15,4,2016
1856,Arizona,San Francisco,10/6/2016,Carl Cheffers,11,84,7,50,4,34,15,5,2016
1857,Washington,Baltimore,10/9/2016,Ron Torbert,13,111,4,46,9,65,14,5,2016
1858,New England,Cleveland,10/9/2016,Bill Vinovich,10,96,5,61,5,35,13,5,2016
1859,Philadelphia,Detroit,10/9/2016,Pete Morelli,16,129,14,111,2,18,17,5,2016
1860,Chicago,Indianapolis,10/9/2016,John Hussey,19,148,10,80,9,68,20,5,2016
1861,Tennessee,Miami,10/9/2016,Craig Wrolstad,13,123,5,40,8,83,16,5,2016
1862,Houston,Minnesota,10/9/2016,Jeff Triplette,13,112,4,15,9,97,14,5,2016
1863,N.Y. Jets,Pittsburgh,10/9/2016,John Parry,5,28,4,18,1,10,10,5,2016
1864,Atlanta,Denver,10/9/2016,Terry McAulay,15,135,7,78,8,57,17,5,2016
1865,Cincinnati,Dallas,10/9/2016,Tony Corrente,13,94,6,49,7,45,13,5,2016
1866,Buffalo,LA Rams,10/9/2016,Walt Coleman,13,100,7,60,6,40,14,5,2016
1867,San Diego,Oakland,10/9/2016,Gene Steratore,10,74,4,38,6,36,11,5,2016
1868,N.Y. Giants,Green Bay,10/9/2016,Ed Hochuli,12,108,6,51,6,57,18,5,2016
1869,Tampa Bay,Carolina,10/10/2016,Clete Blakeman,12,100,5,40,7,60,13,5,2016
1870,Denver,San Diego,10/13/2016,Craig Wrolstad,15,123,12,103,3,20,16,6,2016
1871,San Francisco,Buffalo,10/16/2016,Gene Steratore,13,123,6,52,7,71,14,6,2016
1872,Jacksonville,Chicago,10/16/2016,Clete Blakeman,15,137,5,50,10,87,18,6,2016
1873,LA Rams,Detroit,10/16/2016,John Hussey,15,124,8,62,7,62,19,6,2016
1874,Pittsburgh,Miami,10/16/2016,Ed Hochuli,14,160,6,65,8,95,18,6,2016
1875,Cincinnati,New England,10/16/2016,Ron Torbert,13,101,7,46,6,55,13,6,2016
1876,Carolina,New Orleans,10/16/2016,Walt Anderson,15,177,5,51,10,126,19,6,2016
1877,Baltimore,N.Y. Giants,10/16/2016,Jeff Triplette,22,230,15,111,7,119,23,6,2016
1878,Cleveland,Tennessee,10/16/2016,Carl Cheffers,18,165,11,69,7,96,20,6,2016
1879,Philadelphia,Washington,10/16/2016,John Parry,22,189,13,114,9,75,23,6,2016
1880,Kansas City,Oakland,10/16/2016,Pete Morelli,5,35,2,10,3,25,9,6,2016
1881,Dallas,Green Bay,10/16/2016,Brad Allen,12,83,7,60,5,23,12,6,2016
1882,Atlanta,Seattle,10/16/2016,Tony Corrente,11,96,8,66,3,30,11,6,2016
1883,Indianapolis,Houston,10/16/2016,Bill Vinovich,14,101,7,42,7,59,16,6,2016
1884,N.Y. Jets,Arizona,10/17/2016,Jerome Boger,19,147,10,83,9,64,23,6,2016
1885,Chicago,Green Bay,10/20/2016,John Parry,19,164,10,108,9,56,21,7,2016
1886,N.Y. Giants,LA Rams,10/23/2016,Ron Torbert,11,76,3,33,8,43,16,7,2016
1887,Cleveland,Cincinnati,10/23/2016,Ed Hochuli,8,65,5,35,3,30,9,7,2016
1888,Washington,Detroit,10/23/2016,Walt Coleman,8,50,4,20,4,30,9,7,2016
1889,Oakland,Jacksonville,10/23/2016,Jeff Triplette,24,239,11,117,13,122,35,7,2016
1890,New Orleans,Kansas City,10/23/2016,Clete Blakeman,14,105,10,75,4,30,17,7,2016
1891,Buffalo,Miami,10/23/2016,Brad Allen,19,161,6,45,13,116,25,7,2016
1892,Baltimore,N.Y. Jets,10/23/2016,Walt Anderson,8,60,4,35,4,25,8,7,2016
1893,Minnesota,Philadelphia,10/23/2016,John Hussey,14,109,7,56,7,53,18,7,2016
1894,Indianapolis,Tennessee,10/23/2016,Jerome Boger,18,169,12,131,6,38,18,7,2016
1895,San Diego,Atlanta,10/23/2016,Bill Vinovich,12,84,3,14,9,70,14,7,2016
1896,Tampa Bay,San Francisco,10/23/2016,Pete Morelli,11,109,7,78,4,31,14,7,2016
1897,New England,Pittsburgh,10/23/2016,Craig Wrolstad,14,125,4,40,10,85,17,7,2016
1898,Seattle,Arizona,10/23/2016,Terry McAulay,16,135,10,90,6,45,24,7,2016
1899,Houston,Denver,10/24/2016,Carl Cheffers,9,98,2,15,7,83,12,7,2016
1900,Jacksonville,Tennessee,10/27/2016,John Hussey,14,129,7,75,7,54,15,8,2016
1901,Washington,Cincinnati,10/30/2016,Carl Cheffers,22,191,15,106,7,85,28,8,2016
1902,Green Bay,Atlanta,10/30/2016,Walt Anderson,13,114,6,68,7,46,17,8,2016
1903,New England,Buffalo,10/30/2016,John Parry,22,200,10,116,12,84,23,8,2016
1904,N.Y. Jets,Cleveland,10/30/2016,Pete Morelli,7,47,5,37,2,10,8,8,2016
1905,Detroit,Houston,10/30/2016,Brad Allen,14,124,8,75,6,49,16,8,2016
1906,Kansas City,Indianapolis,10/30/2016,Craig Wrolstad,11,85,6,40,5,45,12,8,2016
1907,Seattle,New Orleans,10/30/2016,Ed Hochuli,13,86,11,76,2,10,14,8,2016
1908,Oakland,Tampa Bay,10/30/2016,Terry McAulay,29,264,23,200,6,64,34,8,2016
1909,San Diego,Denver,10/30/2016,Tony Corrente,14,97,8,52,6,45,20,8,2016
1910,Arizona,Carolina,10/30/2016,Walt Coleman,15,128,10,88,5,40,20,8,2016
1911,Philadelphia,Dallas,10/30/2016,Jerome Boger,16,124,5,40,11,84,18,8,2016
1912,Minnesota,Chicago,10/31/2016,Gene Steratore,3,30,1,10,2,20,5,8,2016
1913,Atlanta,Tampa Bay,11/3/2016,Ron Torbert,17,119,6,34,11,85,21,9,2016
1914,Denver,Oakland,11/6/2016,Clete Blakeman,20,176,12,104,8,72,22,9,2016
1915,Pittsburgh,Baltimore,11/6/2016,John Hussey,23,193,13,99,10,94,25,9,2016
1916,Dallas,Cleveland,11/6/2016,Jeff Triplette,9,71,4,38,5,33,14,9,2016
1917,Jacksonville,Kansas City,11/6/2016,Gene Steratore,13,121,5,46,8,75,15,9,2016
1918,N.Y. Jets,Miami,11/6/2016,Walt Coleman,18,163,10,77,8,86,25,9,2016
1919,Detroit,Minnesota,11/6/2016,Ed Hochuli,14,111,6,57,8,54,14,9,2016
1920,Philadelphia,N.Y. Giants,11/6/2016,Bill Vinovich,9,73,4,43,5,30,12,9,2016
1921,Carolina,LA Rams,11/6/2016,Terry McAulay,15,144,5,35,10,109,17,9,2016
1922,New Orleans,San Francisco,11/6/2016,Jerome Boger,13,118,4,40,9,78,15,9,2016
1923,Indianapolis,Green Bay,11/6/2016,Tony Corrente,8,60,4,35,4,25,13,9,2016
1924,Tennessee,San Diego,11/6/2016,Brad Allen,22,164,8,57,14,107,25,9,2016
1925,Buffalo,Seattle,11/7/2016,Walt Anderson,21,190,11,115,10,75,23,9,2016
1926,Cleveland,Baltimore,11/10/2016,Jerome Boger,9,96,3,35,6,61,12,10,2016
1927,Kansas City,Carolina,11/13/2016,Carl Cheffers,15,98,9,45,6,53,15,10,2016
1928,Houston,Jacksonville,11/13/2016,Ron Torbert,8,137,4,89,4,48,14,10,2016
1929,Denver,New Orleans,11/13/2016,Bill Vinovich,4,35,1,10,3,25,6,10,2016
1930,LA Rams,N.Y. Jets,11/13/2016,Ed Hochuli,11,86,7,55,4,31,13,10,2016
1931,Atlanta,Philadelphia,11/13/2016,Craig Wrolstad,18,144,8,67,10,77,18,10,2016
1932,Chicago,Tampa Bay,11/13/2016,Walt Coleman,18,159,9,74,9,85,19,10,2016
1933,Green Bay,Tennessee,11/13/2016,Jeff Triplette,19,172,12,107,7,65,26,10,2016
1934,Minnesota,Washington,11/13/2016,Pete Morelli,8,70,4,35,4,35,9,10,2016
1935,Miami,San Diego,11/13/2016,Terry McAulay,15,110,11,81,4,29,20,10,2016
1936,San Francisco,Arizona,11/13/2016,Brad Allen,11,110,9,100,2,10,14,10,2016
1937,Dallas,Pittsburgh,11/13/2016,Clete Blakeman,14,138,10,98,4,40,18,10,2016
1938,Seattle,New England,11/13/2016,Gene Steratore,15,121,8,60,7,61,16,10,2016
1939,Cincinnati,N.Y. Giants,11/14/2016,John Parry,11,75,9,60,2,15,12,10,2016
1940,New Orleans,Carolina,11/17/2016,Pete Morelli,12,93,6,48,6,45,14,11,2016
1941,Buffalo,Cincinnati,11/20/2016,Terry McAulay,13,100,9,75,4,25,19,11,2016
1942,Pittsburgh,Cleveland,11/20/2016,Brad Allen,17,122,8,70,9,52,17,11,2016
1943,Baltimore,Dallas,11/20/2016,John Parry,17,181,12,136,5,45,17,11,2016
1944,Jacksonville,Detroit,11/20/2016,Bill Vinovich,9,57,4,25,5,32,11,11,2016
1945,Tennessee,Indianapolis,11/20/2016,Walt Anderson,19,179,11,109,8,70,21,11,2016
1946,Tampa Bay,Kansas City,11/20/2016,Ed Hochuli,12,72,7,42,5,30,12,11,2016
1947,Arizona,Minnesota,11/20/2016,Clete Blakeman,18,169,8,96,10,73,19,11,2016
1948,Chicago,N.Y. Giants,11/20/2016,Craig Wrolstad,9,75,5,40,4,35,9,11,2016
1949,Miami,LA Rams,11/20/2016,Gene Steratore,16,152,8,82,8,70,24,11,2016
1950,New England,San Francisco,11/20/2016,Jeff Triplette,15,108,5,40,10,68,16,11,2016
1951,Philadelphia,Seattle,11/20/2016,Carl Cheffers,15,96,8,48,7,48,19,11,2016
1952,Green Bay,Washington,11/20/2016,John Hussey,12,99,6,59,6,40,15,11,2016
1953,Houston,Oakland,11/21/2016,Tony Corrente,11,122,7,101,4,21,15,11,2016
1954,Minnesota,Detroit,11/24/2016,Carl Cheffers,9,56,5,40,4,16,10,12,2016
1955,Washington,Dallas,11/24/2016,Craig Wrolstad,6,55,3,30,3,25,9,12,2016
1956,Pittsburgh,Indianapolis,11/24/2016,Walt Coleman,9,77,7,67,2,10,11,12,2016
1957,Arizona,Atlanta,11/27/2016,John Parry,12,83,8,60,4,23,12,12,2016
1958,Cincinnati,Baltimore,11/27/2016,Clete Blakeman,10,84,2,15,8,69,13,12,2016
1959,Jacksonville,Buffalo,11/27/2016,Tony Corrente,12,91,6,60,6,31,12,12,2016
1960,Tennessee,Chicago,11/27/2016,Ed Hochuli,13,166,6,118,7,48,13,12,2016
1961,N.Y. Giants,Cleveland,11/27/2016,Walt Anderson,14,135,9,100,5,35,15,12,2016
1962,San Diego,Houston,11/27/2016,Jeff Triplette,19,136,10,78,9,58,23,12,2016
1963,San Francisco,Miami,11/27/2016,Ron Torbert,11,107,7,65,4,42,14,12,2016
1964,LA Rams,New Orleans,11/27/2016,John Hussey,12,107,6,62,6,45,17,12,2016
1965,Seattle,Tampa Bay,11/27/2016,Bill Vinovich,9,95,2,27,7,68,11,12,2016
1966,Kansas City,Denver,11/27/2016,Pete Morelli,24,168,9,71,15,97,26,12,2016
1967,Carolina,Oakland,11/27/2016,Jerome Boger,14,113,7,67,7,46,17,12,2016
1968,New England,N.Y. Jets,11/27/2016,Brad Allen,8,81,2,15,6,66,10,12,2016
1969,Green Bay,Philadelphia,11/28/2016,Terry McAulay,14,93,7,51,7,42,16,12,2016
1970,Dallas,Minnesota,12/1/2016,Tony Corrente,18,135,10,78,8,57,20,13,2016
1971,Kansas City,Atlanta,12/4/2016,Walt Coleman,18,158,13,128,5,30,21,13,2016
1972,Miami,Baltimore,12/4/2016,Carl Cheffers,14,125,7,57,7,68,16,13,2016
1973,San Francisco,Chicago,12/4/2016,Pete Morelli,16,146,11,106,5,40,17,13,2016
1974,Philadelphia,Cincinnati,12/4/2016,Jeff Triplette,13,111,10,88,3,23,13,13,2016
1975,Houston,Green Bay,12/4/2016,Gene Steratore,7,42,3,12,4,30,7,13,2016
1976,Denver,Jacksonville,12/4/2016,Craig Wrolstad,10,97,4,32,6,65,10,13,2016
1977,LA Rams,New England,12/4/2016,Jerome Boger,12,76,4,30,8,46,14,13,2016
1978,Detroit,New Orleans,12/4/2016,Clete Blakeman,16,122,6,39,10,83,20,13,2016
1979,Buffalo,Oakland,12/4/2016,Bill Vinovich,15,138,8,73,7,65,15,13,2016
1980,Washington,Arizona,12/4/2016,Walt Anderson,13,86,7,35,6,51,13,13,2016
1981,N.Y. Giants,Pittsburgh,12/4/2016,Terry McAulay,16,139,4,24,12,115,19,13,2016
1982,Tampa Bay,San Diego,12/4/2016,John Hussey,12,80,6,35,6,45,14,13,2016
1983,Carolina,Seattle,12/4/2016,John Parry,12,100,6,63,6,37,16,13,2016
1984,Indianapolis,N.Y. Jets,12/5/2016,Ron Torbert,9,118,3,28,6,90,9,13,2016
1985,Oakland,Kansas City,12/8/2016,Terry McAulay,19,155,10,82,9,73,21,14,2016
1986,Pittsburgh,Buffalo,12/11/2016,Pete Morelli,13,91,6,45,7,46,15,14,2016
1987,San Diego,Carolina,12/11/2016,Ron Torbert,12,67,7,32,5,35,16,14,2016
1988,Cincinnati,Cleveland,12/11/2016,Gene Steratore,11,77,6,43,5,34,13,14,2016
1989,Chicago,Detroit,12/11/2016,Jeff Triplette,18,194,11,139,7,55,22,14,2016
1990,Houston,Indianapolis,12/11/2016,Brad Allen,16,183,7,124,9,59,19,14,2016
1991,Minnesota,Jacksonville,12/11/2016,John Hussey,21,207,7,93,14,114,24,14,2016
1992,Arizona,Miami,12/11/2016,Jerome Boger,21,172,7,54,14,118,23,14,2016
1993,Washington,Philadelphia,12/11/2016,Tony Corrente,10,140,5,86,5,54,10,14,2016
1994,New Orleans,Tampa Bay,12/11/2016,Walt Anderson,20,169,13,104,7,65,23,14,2016
1995,Denver,Tennessee,12/11/2016,John Parry,14,142,9,87,5,55,15,14,2016
1996,N.Y. Jets,San Francisco,12/11/2016,Craig Wrolstad,12,81,9,56,3,25,16,14,2016
1997,Seattle,Green Bay,12/11/2016,Walt Coleman,12,113,7,63,5,50,14,14,2016
1998,Atlanta,LA Rams,12/11/2016,Clete Blakeman,16,145,5,40,11,105,19,14,2016
1999,Dallas,N.Y. Giants,12/11/2016,Carl Cheffers,12,104,5,54,7,50,13,14,2016
2000,Baltimore,New England,12/12/2016,Ed Hochuli,13,95,8,47,5,48,13,14,2016
2001,LA Rams,Seattle,12/15/2016,Brad Allen,21,162,8,76,13,86,22,15,2016
2002,Miami,N.Y. Jets,12/17/2016,Pete Morelli,12,112,9,70,3,42,14,15,2016
2003,Philadelphia,Baltimore,12/18/2016,Craig Wrolstad,10,92,3,30,7,62,12,15,2016
2004,Cleveland,Buffalo,12/18/2016,Clete Blakeman,9,93,4,51,5,42,11,15,2016
2005,Green Bay,Chicago,12/18/2016,Ron Torbert,14,104,8,64,6,40,15,15,2016
2006,Tampa Bay,Dallas,12/18/2016,Terry McAulay,11,126,3,35,8,91,11,15,2016
2007,Jacksonville,Houston,12/18/2016,Ed Hochuli,18,162,12,91,6,71,21,15,2016
2008,Tennessee,Kansas City,12/18/2016,John Hussey,7,65,2,25,5,40,11,15,2016
2009,Indianapolis,Minnesota,12/18/2016,Jerome Boger,11,82,5,55,6,27,12,15,2016
2010,Detroit,N.Y. Giants,12/18/2016,Tony Corrente,7,61,2,15,5,46,9,15,2016
2011,New Orleans,Arizona,12/18/2016,Carl Cheffers,12,98,5,46,7,52,14,15,2016
2012,San Francisco,Atlanta,12/18/2016,Gene Steratore,8,47,4,20,4,27,8,15,2016
2013,New England,Denver,12/18/2016,Walt Anderson,9,79,4,30,5,49,15,15,2016
2014,Oakland,San Diego,12/18/2016,John Parry,8,59,2,15,6,44,8,15,2016
2015,Pittsburgh,Cincinnati,12/18/2016,Bill Vinovich,15,190,7,104,8,86,16,15,2016
2016,Carolina,Washington,12/19/2016,Walt Coleman,13,132,6,62,7,70,15,15,2016
2017,N.Y. Giants,Philadelphia,12/22/2016,Clete Blakeman,6,55,5,50,1,5,7,16,2016
2018,Miami,Buffalo,12/24/2016,Craig Wrolstad,7,50,2,15,5,35,7,16,2016
2019,Atlanta,Carolina,12/24/2016,Bill Vinovich,10,69,6,45,4,24,10,16,2016
2020,Washington,Chicago,12/24/2016,Brad Allen,11,125,7,73,4,52,15,16,2016
2021,San Diego,Cleveland,12/24/2016,Walt Coleman,13,136,9,92,4,44,15,16,2016
2022,Minnesota,Green Bay,12/24/2016,Jeff Triplette,11,91,8,70,3,21,12,16,2016
2023,Tennessee,Jacksonville,12/24/2016,Pete Morelli,10,94,6,49,4,45,11,16,2016
2024,N.Y. Jets,New England,12/24/2016,Gene Steratore,9,97,6,77,3,20,10,16,2016
2025,Indianapolis,Oakland,12/24/2016,Ed Hochuli,14,115,4,22,10,93,17,16,2016
2026,San Francisco,LA Rams,12/24/2016,Walt Anderson,16,145,11,100,5,45,20,16,2016
2027,Arizona,Seattle,12/24/2016,Ron Torbert,12,125,7,85,5,40,15,16,2016
2028,Cincinnati,Houston,12/24/2016,Carl Cheffers,9,85,6,60,3,25,13,16,2016
2029,Baltimore,Pittsburgh,12/25/2016,John Parry,11,140,7,95,4,45,14,16,2016
2030,Denver,Kansas City,12/25/2016,Tony Corrente,17,135,9,70,8,65,21,16,2016
2031,Detroit,Dallas,12/26/2016,John Hussey,13,109,5,62,8,47,17,16,2016
2032,New Orleans,Atlanta,1/1/2017,Ron Torbert,15,133,6,70,9,63,15,17,2016
2033,Baltimore,Cincinnati,1/1/2017,Pete Morelli,6,61,4,41,2,20,9,17,2016
2034,Green Bay,Detroit,1/1/2017,Jerome Boger,15,105,10,75,5,30,20,17,2016
2035,Jacksonville,Indianapolis,1/1/2017,Clete Blakeman,12,89,8,54,4,35,12,17,2016
2036,New England,Miami,1/1/2017,John Parry,16,137,7,64,9,73,18,17,2016
2037,Chicago,Minnesota,1/1/2017,Terry McAulay,8,64,6,49,2,15,10,17,2016
2038,Buffalo,N.Y. Jets,1/1/2017,Jeff Triplette,2,15,0,0,2,15,4,17,2016
2039,Dallas,Philadelphia,1/1/2017,Walt Coleman,9,96,5,35,4,61,11,17,2016
2040,Cleveland,Pittsburgh,1/1/2017,John Hussey,14,80,5,37,9,43,15,17,2016
2041,Carolina,Tampa Bay,1/1/2017,Carl Cheffers,9,75,4,45,5,30,10,17,2016
2042,Houston,Tennessee,1/1/2017,Bill Vinovich,13,85,6,35,7,50,14,17,2016
2043,N.Y. Giants,Washington,1/1/2017,Gene Steratore,10,84,5,42,5,42,11,17,2016
2044,Oakland,Denver,1/1/2017,Brad Allen,18,168,13,125,5,43,19,17,2016
2045,Arizona,LA Rams,1/1/2017,Craig Wrolstad,13,112,4,51,9,61,16,17,2016
2046,Kansas City,San Diego,1/1/2017,Walt Anderson,14,69,4,19,10,50,16,17,2016
2047,Seattle,San Francisco,1/1/2017,Tony Corrente,8,59,4,34,4,25,8,17,2016
2048,Kansas City,New England,9/7/2017,Bill Vinovich,21,194,15,139,6,55,26,1,2017
2049,N.Y. Jets,Buffalo,9/10/2017,John Hussey,11,112,5,62,6,50,14,1,2017
2050,Atlanta,Chicago,9/10/2017,Jeff Triplette,12,113,8,73,4,40,12,1,2017
2051,Baltimore,Cincinnati,9/10/2017,Walt Coleman,20,151,11,85,9,66,22,1,2017
2052,Pittsburgh,Cleveland,9/10/2017,Craig Wrolstad,17,205,13,144,4,61,17,1,2017
2053,Arizona,Detroit,9/10/2017,Walt Anderson,17,155,7,55,10,100,25,1,2017
2054,Jacksonville,Houston,9/10/2017,Tony Corrente,19,183,10,89,9,94,19,1,2017
2055,Oakland,Tennessee,9/10/2017,Jerome Boger,10,98,5,49,5,49,10,1,2017
2056,Philadelphia,Washington,9/10/2017,Brad Allen,10,91,8,76,2,15,12,1,2017
2057,Indianapolis,LA Rams,9/10/2017,Ron Torbert,11,70,4,20,7,50,16,1,2017
2058,Seattle,Green Bay,9/10/2017,John Parry,16,120,8,50,8,70,24,1,2017
2059,Carolina,San Francisco,9/10/2017,Clete Blakeman,15,114,5,40,10,74,17,1,2017
2060,N.Y. Giants,Dallas,9/10/2017,Carl Cheffers,11,105,6,55,5,50,12,1,2017
2061,New Orleans,Minnesota,9/11/2017,Gene Steratore,11,102,6,52,5,50,15,1,2017
2062,LA Chargers,Denver,9/11/2017,Terry McAulay,7,102,4,40,3,62,9,1,2017
2063,Houston,Cincinnati,9/14/2017,Clete Blakeman,16,106,9,61,7,45,18,2,2017
2064,Cleveland,Baltimore,9/17/2017,Gene Steratore,18,110,11,65,7,45,20,2,2017
2065,Buffalo,Carolina,9/17/2017,Walt Coleman,11,84,5,44,6,40,12,2,2017
2066,Arizona,Indianapolis,9/17/2017,Carl Cheffers,14,111,6,41,8,70,19,2,2017
2067,Tennessee,Jacksonville,9/17/2017,Ed Hochuli,17,169,7,70,10,99,18,2,2017
2068,Philadelphia,Kansas City,9/17/2017,Terry McAulay,9,70,4,30,5,40,13,2,2017
2069,New England,New Orleans,9/17/2017,Craig Wrolstad,14,101,9,66,5,35,15,2,2017
2070,Minnesota,Pittsburgh,9/17/2017,Pete Morelli,21,203,11,131,10,72,25,2,2017
2071,Chicago,Tampa Bay,9/17/2017,Ron Torbert,12,93,8,59,4,34,13,2,2017
2072,Miami,LA Chargers,9/17/2017,Tony Corrente,11,79,5,23,6,56,14,2,2017
2073,N.Y. Jets,Oakland,9/17/2017,Jeff Triplette,14,126,5,47,9,79,14,2,2017
2074,Dallas,Denver,9/17/2017,Brad Allen,16,130,8,69,8,61,20,2,2017
2075,Washington,LA Rams,9/17/2017,Jerome Boger,11,100,4,25,7,75,18,2,2017
2076,San Francisco,Seattle,9/17/2017,Bill Vinovich,15,137,6,66,9,71,17,2,2017
2077,Green Bay,Atlanta,9/17/2017,Walt Anderson,16,104,10,70,6,34,19,2,2017
2078,Detroit,N.Y. Giants,9/18/2017,John Parry,13,100,6,50,7,50,14,2,2017
2079,LA Rams,San Francisco,9/21/2017,Jeff Triplette,17,107,7,52,10,55,20,3,2017
2080,Baltimore,Jacksonville,9/24/2017,Pete Morelli,19,158,10,88,9,70,21,3,2017
2081,Denver,Buffalo,9/24/2017,Carl Cheffers,18,148,10,79,8,69,19,3,2017
2082,New Orleans,Carolina,9/24/2017,Bill Vinovich,2,15,1,10,1,5,3,3,2017
2083,Pittsburgh,Chicago,9/24/2017,Clete Blakeman,16,113,6,40,10,73,19,3,2017
2084,Atlanta,Detroit,9/24/2017,Walt Coleman,17,166,8,68,9,98,21,3,2017
2085,Cleveland,Indianapolis,9/24/2017,Ed Hochuli,21,212,10,113,11,99,22,3,2017
2086,Tampa Bay,Minnesota,9/24/2017,John Hussey,12,90,7,37,5,53,18,3,2017
2087,Houston,New England,9/24/2017,John Parry,15,129,10,60,5,69,17,3,2017
2088,Miami,N.Y. Jets,9/24/2017,Terry McAulay,18,145,8,51,10,94,21,3,2017
2089,N.Y. Giants,Philadelphia,9/24/2017,Jerome Boger,19,240,10,137,9,103,22,3,2017
2090,Seattle,Tennessee,9/24/2017,Ron Torbert,16,143,11,98,5,45,27,3,2017
2091,Cincinnati,Green Bay,9/24/2017,Gene Steratore,11,101,7,68,4,33,13,3,2017
2092,Kansas City,LA Chargers,9/24/2017,Walt Anderson,21,183,13,122,8,61,25,3,2017
2093,Oakland,Washington,9/24/2017,Tony Corrente,14,112,4,35,10,77,17,3,2017
2094,Dallas,Arizona,9/25/2017,Craig Wrolstad,15,126,9,76,6,50,17,3,2017
2095,Chicago,Green Bay,9/28/2017,John Hussey,15,117,8,62,7,55,18,4,2017
2096,New Orleans,Miami,10/1/2017,Ed Hochuli,19,161,8,71,11,90,26,4,2017
2097,Buffalo,Atlanta,10/1/2017,Terry McAulay,13,100,9,55,4,45,15,4,2017
2098,Pittsburgh,Baltimore,10/1/2017,Walt Anderson,14,115,8,60,6,55,18,4,2017
2099,Cincinnati,Cleveland,10/1/2017,Ron Torbert,12,94,8,66,4,28,14,4,2017
2100,LA Rams,Dallas,10/1/2017,Clete Blakeman,11,86,7,41,4,45,15,4,2017
2101,Tennessee,Houston,10/1/2017,Jeff Triplette,9,108,6,88,3,20,14,4,2017
2102,Detroit,Minnesota,10/1/2017,Bill Vinovich,8,70,6,60,2,10,9,4,2017
2103,Carolina,New England,10/1/2017,Jerome Boger,8,88,1,33,7,55,9,4,2017
2104,Jacksonville,N.Y. Jets,10/1/2017,Gene Steratore,16,117,6,47,10,70,17,4,2017
2105,San Francisco,Arizona,10/1/2017,Tony Corrente,23,193,13,113,10,80,26,4,2017
2106,Philadelphia,LA Chargers,10/1/2017,Carl Cheffers,18,97,9,58,9,39,20,4,2017
2107,N.Y. Giants,Tampa Bay,10/1/2017,Craig Wrolstad,5,19,1,0,4,19,10,4,2017
2108,Oakland,Denver,10/1/2017,John Parry,13,115,7,75,6,40,18,4,2017
2109,Indianapolis,Seattle,10/1/2017,Brad Allen,11,76,5,31,6,45,15,4,2017
2110,Washington,Kansas City,10/2/2017,Walt Coleman,10,59,7,44,3,15,12,4,2017
2111,New England,Tampa Bay,10/5/2017,Carl Cheffers,21,178,12,108,9,70,22,5,2017
2112,Buffalo,Cincinnati,10/8/2017,Pete Morelli,12,142,6,71,6,71,13,5,2017
2113,N.Y. Jets,Cleveland,10/8/2017,Walt Anderson,15,140,9,80,6,60,17,5,2017
2114,Carolina,Detroit,10/8/2017,Craig Wrolstad,12,110,11,100,1,10,18,5,2017
2115,San Francisco,Indianapolis,10/8/2017,Walt Coleman,17,139,10,77,7,62,18,5,2017
2116,Tennessee,Miami,10/8/2017,Bill Vinovich,16,100,11,77,5,23,19,5,2017
2117,LA Chargers,N.Y. Giants,10/8/2017,Jeff Triplette,21,154,11,87,10,67,27,5,2017
2118,Arizona,Philadelphia,10/8/2017,John Hussey,12,121,7,61,5,60,14,5,2017
2119,Jacksonville,Pittsburgh,10/8/2017,John Parry,9,56,4,19,5,37,11,5,2017
2120,Seattle,LA Rams,10/8/2017,Gene Steratore,12,85,7,40,5,45,14,5,2017
2121,Baltimore,Oakland,10/8/2017,Brad Allen,4,29,1,5,3,24,4,5,2017
2122,Green Bay,Dallas,10/8/2017,Terry McAulay,13,108,6,38,7,70,16,5,2017
2123,Kansas City,Houston,10/8/2017,Ron Torbert,13,123,6,64,7,59,17,5,2017
2124,Minnesota,Chicago,10/9/2017,Jerome Boger,17,124,9,69,8,55,20,5,2017
2125,Philadelphia,Carolina,10/12/2017,Pete Morelli,11,127,10,126,1,1,14,6,2017
2126,Miami,Atlanta,10/15/2017,John Hussey,10,115,4,42,6,73,13,6,2017
2127,Chicago,Baltimore,10/15/2017,Ed Hochuli,13,113,5,44,8,69,15,6,2017
2128,Cleveland,Houston,10/15/2017,Brad Allen,15,116,11,72,4,44,19,6,2017
2129,Green Bay,Minnesota,10/15/2017,Ron Torbert,15,157,8,92,7,65,17,6,2017
2130,Detroit,New Orleans,10/15/2017,Jeff Triplette,20,164,7,46,13,118,24,6,2017
2131,New England,N.Y. Jets,10/15/2017,Tony Corrente,12,114,6,45,6,69,14,6,2017
2132,San Francisco,Washington,10/15/2017,John Parry,12,83,7,40,5,43,13,6,2017
2133,Tampa Bay,Arizona,10/15/2017,Gene Steratore,16,110,9,49,7,61,19,6,2017
2134,LA Rams,Jacksonville,10/15/2017,Walt Coleman,12,110,7,70,5,40,13,6,2017
2135,Pittsburgh,Kansas City,10/15/2017,Carl Cheffers,13,105,6,57,7,48,15,6,2017
2136,LA Chargers,Oakland,10/15/2017,Clete Blakeman,9,72,4,32,5,40,10,6,2017
2137,N.Y. Giants,Denver,10/15/2017,Bill Vinovich,10,123,5,77,5,46,13,6,2017
2138,Indianapolis,Tennessee,10/16/2017,Walt Anderson,9,96,5,51,4,45,11,6,2017
2139,Kansas City,Oakland,10/19/2017,Craig Wrolstad,18,205,8,108,10,97,19,7,2017
2140,Tampa Bay,Buffalo,10/22/2017,Clete Blakeman,9,90,5,55,4,35,10,7,2017
2141,Carolina,Chicago,10/22/2017,Walt Anderson,9,75,4,35,5,40,10,7,2017
2142,Tennessee,Cleveland,10/22/2017,Terry McAulay,17,116,5,35,12,81,19,7,2017
2143,New Orleans,Green Bay,10/22/2017,Jerome Boger,15,134,7,80,8,54,20,7,2017
2144,Jacksonville,Indianapolis,10/22/2017,Jeff Triplette,9,89,4,34,5,55,11,7,2017
2145,Arizona,LA Rams,10/22/2017,Brad Allen,16,110,10,65,6,45,20,7,2017
2146,N.Y. Jets,Miami,10/22/2017,Walt Coleman,21,200,12,124,9,76,25,7,2017
2147,Baltimore,Minnesota,10/22/2017,Carl Cheffers,7,62,3,15,4,47,8,7,2017
2148,Cincinnati,Pittsburgh,10/22/2017,Bill Vinovich,6,59,5,54,1,5,6,7,2017
2149,Dallas,San Francisco,10/22/2017,Ron Torbert,7,58,5,36,2,22,11,7,2017
2150,Denver,LA Chargers,10/22/2017,John Hussey,19,149,10,68,9,81,20,7,2017
2151,Seattle,N.Y. Giants,10/22/2017,Tony Corrente,22,138,15,110,7,28,23,7,2017
2152,Atlanta,New England,10/22/2017,Gene Steratore,14,105,6,40,8,65,17,7,2017
2153,Washington,Philadelphia,10/23/2017,Ed Hochuli,14,110,5,55,9,55,16,7,2017
2154,Miami,Baltimore,10/26/2017,John Parry,12,83,7,43,5,40,17,8,2017
2155,Minnesota,Cleveland,10/29/2017,Jeff Triplette,10,132,5,58,5,74,13,8,2017
2156,Oakland,Buffalo,10/29/2017,Ed Hochuli,17,145,6,50,11,95,18,8,2017
2157,Indianapolis,Cincinnati,10/29/2017,Jerome Boger,12,99,7,45,5,54,14,8,2017
2158,LA Chargers,New England,10/29/2017,Pete Morelli,16,157,10,77,6,80,19,8,2017
2159,Chicago,New Orleans,10/29/2017,Carl Cheffers,11,82,4,31,7,51,15,8,2017
2160,Atlanta,N.Y. Jets,10/29/2017,Craig Wrolstad,12,118,6,68,6,50,15,8,2017
2161,San Francisco,Philadelphia,10/29/2017,Clete Blakeman,10,104,6,69,4,35,12,8,2017
2162,Carolina,Tampa Bay,10/29/2017,Walt Coleman,11,106,5,51,6,55,12,8,2017
2163,Houston,Seattle,10/29/2017,Terry McAulay,18,213,8,93,10,120,22,8,2017
2164,Dallas,Washington,10/29/2017,Walt Anderson,13,121,8,89,5,32,14,8,2017
2165,Pittsburgh,Detroit,10/29/2017,John Hussey,11,94,5,37,6,57,12,8,2017
2166,Denver,Kansas City,10/30/2017,Tony Corrente,14,122,7,53,7,69,18,8,2017
2167,Buffalo,N.Y. Jets,11/2/2017,Jerome Boger,21,165,11,99,10,66,26,9,2017
2168,Atlanta,Carolina,11/5/2017,Tony Corrente,13,99,8,70,5,29,15,9,2017
2169,Indianapolis,Houston,11/5/2017,John Parry,13,142,6,68,7,74,16,9,2017
2170,Cincinnati,Jacksonville,11/5/2017,Brad Allen,13,128,8,78,5,50,17,9,2017
2171,Tampa Bay,New Orleans,11/5/2017,Bill Vinovich,11,78,7,50,4,28,11,9,2017
2172,LA Rams,N.Y. Giants,11/5/2017,Ed Hochuli,10,107,6,55,4,52,10,9,2017
2173,Denver,Philadelphia,11/5/2017,Gene Steratore,19,140,14,105,5,35,22,9,2017
2174,Baltimore,Tennessee,11/5/2017,John Hussey,9,78,6,39,3,39,12,9,2017
2175,Arizona,San Francisco,11/5/2017,Craig Wrolstad,10,78,2,25,8,53,14,9,2017
2176,Washington,Seattle,11/5/2017,Ron Torbert,23,200,7,62,16,138,25,9,2017
2177,Kansas City,Dallas,11/5/2017,Pete Morelli,13,117,8,52,5,65,13,9,2017
2178,Oakland,Miami,11/5/2017,Terry McAulay,21,212,10,105,11,107,22,9,2017
2179,Detroit,Green Bay,11/6/2017,Clete Blakeman,4,39,2,19,2,20,5,9,2017
2180,Seattle,Arizona,11/9/2017,Walt Anderson,21,166,12,108,9,58,23,10,2017
2181,New Orleans,Buffalo,11/12/2017,Terry McAulay,12,97,4,41,8,56,17,10,2017
2182,Green Bay,Chicago,11/12/2017,Tony Corrente,13,113,5,35,8,78,17,10,2017
2183,Cleveland,Detroit,11/12/2017,Carl Cheffers,14,141,7,60,7,81,16,10,2017
2184,Pittsburgh,Indianapolis,11/12/2017,Clete Blakeman,18,152,9,70,9,82,19,10,2017
2185,LA Chargers,Jacksonville,11/12/2017,Ron Torbert,16,183,7,77,9,106,21,10,2017
2186,N.Y. Jets,Tampa Bay,11/12/2017,Brad Allen,14,127,8,77,6,50,15,10,2017
2187,Cincinnati,Tennessee,11/12/2017,Jeff Triplette,17,139,12,84,5,55,19,10,2017
2188,Minnesota,Washington,11/12/2017,Bill Vinovich,5,55,3,40,2,15,5,10,2017
2189,Houston,LA Rams,11/12/2017,Pete Morelli,18,146,8,60,10,86,19,10,2017
2190,Dallas,Atlanta,11/12/2017,Ed Hochuli,10,89,5,54,5,35,16,10,2017
2191,N.Y. Giants,San Francisco,11/12/2017,Jerome Boger,10,79,4,35,6,44,13,10,2017
2192,New England,Denver,11/12/2017,Walt Coleman,6,33,1,5,5,28,9,10,2017
2193,Miami,Carolina,11/13/2017,Gene Steratore,13,94,7,57,6,37,14,10,2017
2194,Tennessee,Pittsburgh,11/16/2017,Ron Torbert,16,126,9,65,7,61,18,11,2017
2195,Detroit,Chicago,11/19/2017,Brad Allen,11,113,6,49,5,64,11,11,2017
2196,Jacksonville,Cleveland,11/19/2017,Pete Morelli,6,40,6,40,0,0,7,11,2017
2197,Baltimore,Green Bay,11/19/2017,Jeff Triplette,8,83,3,30,5,53,8,11,2017
2198,Arizona,Houston,11/19/2017,Ed Hochuli,16,132,10,90,6,42,21,11,2017
2199,LA Rams,Minnesota,11/19/2017,Walt Anderson,15,125,8,60,7,65,18,11,2017
2200,Washington,New Orleans,11/19/2017,Walt Coleman,16,121,9,67,7,54,17,11,2017
2201,Kansas City,N.Y. Giants,11/19/2017,Gene Steratore,14,135,9,87,5,48,16,11,2017
2202,Buffalo,LA Chargers,11/19/2017,John Parry,7,61,6,48,1,13,8,11,2017
2203,Cincinnati,Denver,11/19/2017,Craig Wrolstad,8,64,3,14,5,50,8,11,2017
2204,New England,Oakland,11/19/2017,John Hussey,10,76,2,10,8,66,10,11,2017
2205,Philadelphia,Dallas,11/19/2017,Bill Vinovich,5,40,3,30,2,10,6,11,2017
2206,Tampa Bay,Miami,11/19/2017,Tony Corrente,26,205,9,82,17,123,30,11,2017
2207,Atlanta,Seattle,11/20/2017,Carl Cheffers,16,175,7,69,9,106,21,11,2017
2208,Minnesota,Detroit,11/23/2017,Tony Corrente,17,128,9,74,8,54,22,12,2017
2209,LA Chargers,Dallas,11/23/2017,Jerome Boger,12,116,5,56,7,60,14,12,2017
2210,N.Y. Giants,Washington,11/23/2017,Terry McAulay,14,134,6,79,8,55,19,12,2017
2211,Tampa Bay,Atlanta,11/26/2017,Jeff Triplette,6,57,2,15,4,42,6,12,2017
2212,Cleveland,Cincinnati,11/26/2017,John Hussey,11,104,7,69,4,35,12,12,2017
2213,Tennessee,Indianapolis,11/26/2017,Craig Wrolstad,11,82,2,15,9,67,11,12,2017
2214,Buffalo,Kansas City,11/26/2017,Bill Vinovich,12,100,6,50,6,50,12,12,2017
2215,Miami,New England,11/26/2017,Ron Torbert,13,122,6,52,7,70,15,12,2017
2216,Carolina,N.Y. Jets,11/26/2017,Carl Cheffers,17,152,10,84,7,68,17,12,2017
2217,Chicago,Philadelphia,11/26/2017,Walt Coleman,20,126,9,56,11,70,20,12,2017
2218,New Orleans,LA Rams,11/26/2017,John Parry,16,202,7,112,9,90,20,12,2017
2219,Seattle,San Francisco,11/26/2017,Pete Morelli,13,109,6,35,7,74,15,12,2017
2220,Jacksonville,Arizona,11/26/2017,Clete Blakeman,15,143,5,45,10,98,15,12,2017
2221,Denver,Oakland,11/26/2017,Walt Anderson,16,143,9,75,7,68,20,12,2017
2222,Green Bay,Pittsburgh,11/26/2017,Ed Hochuli,8,72,3,27,5,45,13,12,2017
2223,Houston,Baltimore,11/27/2017,Brad Allen,13,125,6,36,7,89,16,12,2017
2224,Washington,Dallas,11/30/2017,Craig Wrolstad,10,68,7,43,3,25,12,13,2017
2225,Minnesota,Atlanta,12/3/2017,Brad Allen,13,106,6,51,7,55,15,13,2017
2226,Detroit,Baltimore,12/3/2017,Jerome Boger,8,70,6,45,2,25,11,13,2017
2227,New England,Buffalo,12/3/2017,Gene Steratore,12,100,9,66,3,34,18,13,2017
2228,San Francisco,Chicago,12/3/2017,Ed Hochuli,12,82,8,53,4,29,14,13,2017
2229,Tampa Bay,Green Bay,12/3/2017,Terry McAulay,15,121,8,74,7,47,19,13,2017
2230,Indianapolis,Jacksonville,12/3/2017,Bill Vinovich,10,86,4,31,6,55,14,13,2017
2231,Denver,Miami,12/3/2017,Carl Cheffers,16,142,9,57,7,85,21,13,2017
2232,Carolina,New Orleans,12/3/2017,John Hussey,13,122,6,54,7,68,16,13,2017
2233,Kansas City,N.Y. Jets,12/3/2017,John Parry,13,70,8,30,5,40,13,13,2017
2234,Houston,Tennessee,12/3/2017,Clete Blakeman,18,148,11,85,7,63,22,13,2017
2235,Cleveland,LA Chargers,12/3/2017,Walt Coleman,9,86,4,24,5,62,10,13,2017
2236,LA Rams,Arizona,12/3/2017,Ron Torbert,11,61,7,36,4,25,14,13,2017
2237,N.Y. Giants,Oakland,12/3/2017,Pete Morelli,7,47,1,5,6,42,9,13,2017
2238,Philadelphia,Seattle,12/3/2017,Tony Corrente,12,110,7,64,5,46,14,13,2017
2239,Pittsburgh,Cincinnati,12/4/2017,Walt Anderson,20,239,7,66,13,173,23,13,2017
2240,New Orleans,Atlanta,12/7/2017,Clete Blakeman,15,122,11,87,4,35,18,14,2017
2241,Indianapolis,Buffalo,12/10/2017,Brad Allen,4,30,2,20,2,10,5,14,2017
2242,Minnesota,Carolina,12/10/2017,Terry McAulay,8,78,2,30,6,48,9,14,2017
2243,Chicago,Cincinnati,12/10/2017,John Parry,17,130,10,74,7,56,18,14,2017
2244,Green Bay,Cleveland,12/10/2017,Bill Vinovich,9,65,3,20,6,45,9,14,2017
2245,San Francisco,Houston,12/10/2017,John Hussey,19,169,11,87,8,82,23,14,2017
2246,Seattle,Jacksonville,12/10/2017,Gene Steratore,13,121,6,73,7,48,22,14,2017
2247,Oakland,Kansas City,12/10/2017,Carl Cheffers,14,108,7,39,7,69,14,14,2017
2248,Detroit,Tampa Bay,12/10/2017,Ed Hochuli,15,170,8,105,7,65,16,14,2017
2249,Tennessee,Arizona,12/10/2017,Jerome Boger,11,78,6,48,5,30,15,14,2017
2250,N.Y. Jets,Denver,12/10/2017,Tony Corrente,7,41,4,20,3,21,10,14,2017
2251,Washington,LA Chargers,12/10/2017,Jeff Triplette,9,88,4,48,5,40,14,14,2017
2252,Philadelphia,LA Rams,12/10/2017,Craig Wrolstad,17,169,10,67,7,102,17,14,2017
2253,Dallas,N.Y. Giants,12/10/2017,Walt Anderson,15,120,8,51,7,69,15,14,2017
2254,Baltimore,Pittsburgh,12/10/2017,Walt Coleman,11,136,5,35,6,101,18,14,2017
2255,New England,Miami,12/11/2017,Pete Morelli,17,180,9,78,8,102,19,14,2017
2256,Denver,Indianapolis,12/14/2017,Terry McAulay,16,119,12,80,4,39,19,15,2017
2257,Chicago,Detroit,12/16/2017,Jeff Triplette,21,155,13,97,8,58,22,15,2017
2258,LA Chargers,Kansas City,12/16/2017,Walt Anderson,16,132,9,61,7,71,19,15,2017
2259,Miami,Buffalo,12/17/2017,Jerome Boger,10,88,7,60,3,28,13,15,2017
2260,Green Bay,Carolina,12/17/2017,Craig Wrolstad,11,68,6,28,5,40,15,15,2017
2261,Baltimore,Cleveland,12/17/2017,Clete Blakeman,13,92,7,57,6,35,14,15,2017
2262,Houston,Jacksonville,12/17/2017,Carl Cheffers,22,181,14,127,8,54,26,15,2017
2263,Cincinnati,Minnesota,12/17/2017,Walt Coleman,16,137,5,44,11,93,16,15,2017
2264,N.Y. Jets,New Orleans,12/17/2017,Ron Torbert,16,142,8,50,8,92,17,15,2017
2265,Philadelphia,N.Y. Giants,12/17/2017,Brad Allen,12,111,7,44,5,67,16,15,2017
2266,Arizona,Washington,12/17/2017,Pete Morelli,15,153,8,71,7,82,15,15,2017
2267,LA Rams,Seattle,12/17/2017,Ed Hochuli,12,85,3,25,9,60,18,15,2017
2268,New England,Pittsburgh,12/17/2017,Tony Corrente,8,67,2,4,6,63,8,15,2017
2269,Tennessee,San Francisco,12/17/2017,John Parry,10,92,3,22,7,70,11,15,2017
2270,Dallas,Oakland,12/17/2017,Gene Steratore,21,205,7,100,14,105,23,15,2017
2271,Atlanta,Tampa Bay,12/18/2017,John Hussey,13,113,6,60,7,53,14,15,2017
2272,Indianapolis,Baltimore,12/23/2017,Tony Corrente,7,44,2,19,5,25,8,16,2017
2273,Minnesota,Green Bay,12/23/2017,Carl Cheffers,8,89,2,10,6,79,10,16,2017
2274,Tampa Bay,Carolina,12/24/2017,Jerome Boger,18,122,12,72,6,50,21,16,2017
2275,Cleveland,Chicago,12/24/2017,Terry McAulay,12,85,8,60,4,25,14,16,2017
2276,Detroit,Cincinnati,12/24/2017,Gene Steratore,14,134,9,74,5,60,14,16,2017
2277,Miami,Kansas City,12/24/2017,Jeff Triplette,16,115,11,75,5,40,17,16,2017
2278,Buffalo,New England,12/24/2017,Craig Wrolstad,6,93,4,83,2,10,9,16,2017
2279,Atlanta,New Orleans,12/24/2017,Pete Morelli,13,121,10,91,3,30,16,16,2017
2280,LA Chargers,N.Y. Jets,12/24/2017,Clete Blakeman,13,114,8,80,5,34,16,16,2017
2281,LA Rams,Tennessee,12/24/2017,Brad Allen,10,98,5,44,5,54,14,16,2017
2282,Denver,Washington,12/24/2017,Ed Hochuli,9,65,3,30,6,35,10,16,2017
2283,Jacksonville,San Francisco,12/24/2017,Walt Anderson,20,167,12,99,8,68,20,16,2017
2284,N.Y. Giants,Arizona,12/24/2017,John Parry,16,146,10,101,6,45,19,16,2017
2285,Seattle,Dallas,12/24/2017,John Hussey,18,217,11,142,7,75,19,16,2017
2286,Pittsburgh,Houston,12/25/2017,Bill Vinovich,11,104,4,24,7,80,13,16,2017
2287,Oakland,Philadelphia,12/25/2017,Ron Torbert,15,110,7,50,8,60,17,16,2017
2288,Carolina,Atlanta,12/31/2017,Bill Vinovich,12,95,5,35,7,60,12,17,2017
2289,Cincinnati,Baltimore,12/31/2017,Ron Torbert,11,107,6,60,5,47,15,17,2017
2290,Green Bay,Detroit,12/31/2017,Pete Morelli,13,130,8,68,5,62,14,17,2017
2291,Houston,Indianapolis,12/31/2017,Gene Steratore,11,54,7,34,4,20,15,17,2017
2292,Buffalo,Miami,12/31/2017,Jeff Triplette,20,190,6,45,14,145,26,17,2017
2293,Chicago,Minnesota,12/31/2017,Craig Wrolstad,22,219,10,116,12,103,23,17,2017
2294,N.Y. Jets,New England,12/31/2017,Brad Allen,13,133,9,84,4,49,14,17,2017
2295,Washington,N.Y. Giants,12/31/2017,John Hussey,7,60,4,35,3,25,7,17,2017
2296,Dallas,Philadelphia,12/31/2017,John Parry,14,113,7,64,7,49,16,17,2017
2297,Cleveland,Pittsburgh,12/31/2017,Jerome Boger,12,92,9,77,3,15,13,17,2017
2298,New Orleans,Tampa Bay,12/31/2017,Walt Anderson,9,53,7,38,2,15,10,17,2017
2299,Jacksonville,Tennessee,12/31/2017,Tony Corrente,8,56,6,41,2,15,8,17,2017
2300,Kansas City,Denver,12/31/2017,Clete Blakeman,8,70,4,40,4,30,10,17,2017
2301,Oakland,LA Chargers,12/31/2017,Ed Hochuli,13,150,6,85,7,65,15,17,2017
2302,San Francisco,LA Rams,12/31/2017,Terry McAulay,10,69,4,23,6,46,11,17,2017
2303,Arizona,Seattle,12/31/2017,Walt Coleman,12,125,4,25,8,100,15,17,2017
2304,Atlanta,Philadelphia,9/6/2018,John Hussey,26,236,15,135,11,101,28,1,2018
2305,Buffalo,Baltimore,9/9/2018,Shawn Hochuli,19,178,10,100,9,78,24,1,2018
2306,Pittsburgh,Cleveland,9/9/2018,Shawn Smith,23,203,12,116,11,87,29,1,2018
2307,Cincinnati,Indianapolis,9/9/2018,Pete Morelli,15,185,8,94,7,91,17,1,2018
2308,Tennessee,Miami,9/9/2018,Jerome Boger,12,99,5,48,7,51,17,1,2018
2309,San Francisco,Minnesota,9/9/2018,Clay Martin,10,73,3,21,7,52,11,1,2018
2310,Houston,New England,9/9/2018,Tony Corrente,12,80,6,44,6,36,13,1,2018
2311,Tampa Bay,New Orleans,9/9/2018,John Parry,15,147,7,70,8,77,21,1,2018
2312,Jacksonville,N.Y. Giants,9/9/2018,Craig Wrolstad,17,162,11,119,6,43,18,1,2018
2313,Kansas City,LA Chargers,9/9/2018,Clete Blakeman,13,95,6,50,7,45,16,1,2018
2314,Washington,Arizona,9/9/2018,Walt Coleman,18,130,9,63,9,67,21,1,2018
2315,Dallas,Carolina,9/9/2018,Walt Anderson,19,165,10,85,9,80,21,1,2018
2316,Seattle,Denver,9/9/2018,Brad Allen,14,105,7,45,7,60,16,1,2018
2317,Chicago,Green Bay,9/9/2018,Carl Cheffers,13,107,5,35,8,72,14,1,2018
2318,N.Y. Jets,Detroit,9/10/2018,Bill Vinovich,10,64,7,49,3,15,10,1,2018
2319,LA Rams,Oakland,9/10/2018,Ron Torbert,19,225,8,70,11,155,20,1,2018
2320,Baltimore,Cincinnati,9/13/2018,Walt Anderson,16,143,7,51,9,92,18,2,2018
2321,Carolina,Atlanta,9/16/2018,Bill Vinovich,9,75,7,49,2,26,16,2,2018
2322,LA Chargers,Buffalo,9/16/2018,Clay Martin,12,76,6,45,6,31,13,2,2018
2323,Minnesota,Green Bay,9/16/2018,Tony Corrente,15,124,8,70,7,54,19,2,2018
2324,Cleveland,New Orleans,9/16/2018,Ron Torbert,8,96,4,43,4,53,9,2,2018
2325,Miami,N.Y. Jets,9/16/2018,Brad Allen,9,60,2,10,7,50,10,2,2018
2326,Kansas City,Pittsburgh,9/16/2018,Jerome Boger,24,166,12,76,12,90,27,2,2018
2327,Philadelphia,Tampa Bay,9/16/2018,Alex Kemp,10,99,6,55,4,44,14,2,2018
2328,Houston,Tennessee,9/16/2018,Pete Morelli,19,158,11,88,8,70,19,2,2018
2329,Indianapolis,Washington,9/16/2018,Clete Blakeman,13,116,6,26,7,90,13,2,2018
2330,Arizona,LA Rams,9/16/2018,Craig Wrolstad,14,96,9,47,5,49,14,2,2018
2331,Detroit,San Francisco,9/16/2018,Shawn Hochuli,19,191,10,105,9,86,23,2,2018
2332,Oakland,Denver,9/16/2018,John Hussey,10,65,4,30,6,35,14,2,2018
2333,New England,Jacksonville,9/16/2018,Carl Cheffers,9,96,2,25,7,71,9,2,2018
2334,N.Y. Giants,Dallas,9/16/2018,John Parry,9,71,3,24,6,47,10,2,2018
2335,Seattle,Chicago,9/17/2018,Walt Coleman,12,92,5,37,7,55,12,2,2018
2336,N.Y. Jets,Cleveland,9/20/2018,Jerome Boger,11,96,6,55,5,41,19,3,2018
2337,New Orleans,Atlanta,9/23/2018,Walt Anderson,16,174,11,120,5,54,18,3,2018
2338,Denver,Baltimore,9/23/2018,Ron Torbert,20,172,13,120,7,52,20,3,2018
2339,Cincinnati,Carolina,9/23/2018,John Parry,7,53,4,36,3,17,8,3,2018
2340,N.Y. Giants,Houston,9/23/2018,Walt Coleman,10,70,3,20,7,50,17,3,2018
2341,Tennessee,Jacksonville,9/23/2018,Shawn Smith,12,105,4,30,8,75,12,3,2018
2342,San Francisco,Kansas City,9/23/2018,Tony Corrente,20,195,14,147,6,48,26,3,2018
2343,Oakland,Miami,9/23/2018,Shawn Hochuli,17,112,8,38,9,74,22,3,2018
2344,Buffalo,Minnesota,9/23/2018,Alex Kemp,18,143,12,84,6,59,19,3,2018
2345,Indianapolis,Philadelphia,9/23/2018,Clay Martin,21,187,11,77,10,110,25,3,2018
2346,Green Bay,Washington,9/23/2018,Craig Wrolstad,17,181,11,115,6,66,19,3,2018
2347,LA Chargers,LA Rams,9/23/2018,John Hussey,10,94,4,30,6,64,10,3,2018
2348,Chicago,Arizona,9/23/2018,Bill Vinovich,13,88,7,45,6,43,15,3,2018
2349,Dallas,Seattle,9/23/2018,Carl Cheffers,17,122,7,55,10,67,18,3,2018
2350,New England,Detroit,9/23/2018,Clete Blakeman,11,108,5,38,6,70,12,3,2018
2351,Pittsburgh,Tampa Bay,9/24/2018,Pete Morelli,22,235,13,155,9,80,26,3,2018
2352,Minnesota,LA Rams,9/27/2018,Brad Allen,6,50,4,35,2,15,10,4,2018
2353,Cincinnati,Atlanta,9/30/2018,Shawn Smith,16,150,6,55,10,95,21,4,2018
2354,Tampa Bay,Chicago,9/30/2018,Jerome Boger,15,137,11,99,4,38,18,4,2018
2355,Detroit,Dallas,9/30/2018,Walt Coleman,10,78,8,58,2,20,13,4,2018
2356,Buffalo,Green Bay,9/30/2018,Bill Vinovich,8,80,3,20,5,60,9,4,2018
2357,Houston,Indianapolis,9/30/2018,Carl Cheffers,20,139,10,54,10,85,23,4,2018
2358,N.Y. Jets,Jacksonville,9/30/2018,Clay Martin,15,132,6,43,9,89,16,4,2018
2359,Miami,New England,9/30/2018,Alex Kemp,16,146,10,89,6,57,19,4,2018
2360,Philadelphia,Tennessee,9/30/2018,Shawn Hochuli,12,107,8,77,4,30,13,4,2018
2361,Seattle,Arizona,9/30/2018,John Hussey,13,95,8,57,5,38,14,4,2018
2362,Cleveland,Oakland,9/30/2018,Walt Anderson,14,120,8,55,6,65,16,4,2018
2363,San Francisco,LA Chargers,9/30/2018,Ron Torbert,9,78,4,29,5,49,9,4,2018
2364,New Orleans,N.Y. Giants,9/30/2018,Pete Morelli,11,118,5,51,6,67,12,4,2018
2365,Baltimore,Pittsburgh,9/30/2018,Tony Corrente,12,90,7,50,5,40,13,4,2018
2366,Kansas City,Denver,10/1/2018,Craig Wrolstad,13,118,10,93,3,25,15,4,2018
2367,Indianapolis,New England,10/4/2018,Shawn Hochuli,11,85,4,35,7,50,15,5,2018
2368,Tennessee,Buffalo,10/7/2018,Tony Corrente,9,70,5,40,4,30,10,5,2018
2369,N.Y. Giants,Carolina,10/7/2018,Jerome Boger,12,84,8,62,4,22,15,5,2018
2370,Miami,Cincinnati,10/7/2018,Craig Wrolstad,15,132,9,85,6,47,18,5,2018
2371,Baltimore,Cleveland,10/7/2018,John Hussey,14,107,4,41,10,66,18,5,2018
2372,Green Bay,Detroit,10/7/2018,Pete Morelli,20,183,12,112,8,71,25,5,2018
2373,Jacksonville,Kansas City,10/7/2018,Brad Allen,16,150,5,45,11,105,18,5,2018
2374,Denver,N.Y. Jets,10/7/2018,Clay Martin,10,78,6,45,4,33,12,5,2018
2375,Atlanta,Pittsburgh,10/7/2018,John Parry,14,133,7,75,7,58,16,5,2018
2376,Oakland,LA Chargers,10/7/2018,Alex Kemp,16,137,7,55,9,82,19,5,2018
2377,Minnesota,Philadelphia,10/7/2018,Walt Coleman,12,75,4,23,8,52,15,5,2018
2378,Arizona,San Francisco,10/7/2018,Shawn Smith,14,111,5,46,9,65,17,5,2018
2379,LA Rams,Seattle,10/7/2018,Clete Blakeman,14,95,7,45,7,50,17,5,2018
2380,Dallas,Houston,10/7/2018,Bill Vinovich,12,97,7,72,5,25,12,5,2018
2381,Washington,New Orleans,10/8/2018,Carl Cheffers,10,83,6,38,4,45,12,5,2018
2382,Philadelphia,N.Y. Giants,10/11/2018,Ron Torbert,9,86,4,25,5,61,13,6,2018
2383,Tampa Bay,Atlanta,10/14/2018,Walt Coleman,9,50,4,20,5,30,13,6,2018
2384,Pittsburgh,Cincinnati,10/14/2018,Clete Blakeman,15,99,9,69,6,30,16,6,2018
2385,LA Chargers,Cleveland,10/14/2018,Brad Allen,16,125,10,72,6,53,20,6,2018
2386,Buffalo,Houston,10/14/2018,Craig Wrolstad,18,154,12,104,6,50,19,6,2018
2387,Chicago,Miami,10/14/2018,Walt Anderson,13,125,6,58,7,67,15,6,2018
2388,Arizona,Minnesota,10/14/2018,Jerome Boger,14,82,5,30,9,52,17,6,2018
2389,Indianapolis,N.Y. Jets,10/14/2018,Alex Kemp,15,115,8,66,7,49,16,6,2018
2390,Seattle,Oakland,10/14/2018,Pete Morelli,13,102,8,64,5,38,13,6,2018
2391,Carolina,Washington,10/14/2018,Clay Martin,13,98,8,55,5,43,13,6,2018
2392,LA Rams,Denver,10/14/2018,Shawn Smith,16,142,10,81,6,61,16,6,2018
2393,Jacksonville,Dallas,10/14/2018,Tony Corrente,7,55,4,30,3,25,7,6,2018
2394,Baltimore,Tennessee,10/14/2018,Carl Cheffers,14,105,10,70,4,35,16,6,2018
2395,Kansas City,New England,10/14/2018,John Hussey,5,58,5,58,0,0,10,6,2018
2396,San Francisco,Green Bay,10/15/2018,John Parry,8,64,2,10,6,54,13,6,2018
2397,Denver,Arizona,10/18/2018,Alex Kemp,12,95,5,50,7,45,13,7,2018
2398,Tennessee,LA Chargers,10/21/2018,Walt Coleman,8,63,4,32,4,31,9,7,2018
2399,New Orleans,Baltimore,10/21/2018,John Parry,11,106,6,52,5,54,12,7,2018
2400,New England,Chicago,10/21/2018,Clay Martin,12,104,7,64,5,40,15,7,2018
2401,Buffalo,Indianapolis,10/21/2018,Brad Allen,11,94,7,59,4,35,12,7,2018
2402,Houston,Jacksonville,10/21/2018,Ron Torbert,8,50,6,35,2,15,8,7,2018
2403,Cincinnati,Kansas City,10/21/2018,Bill Vinovich,16,108,8,58,8,50,16,7,2018
2404,Detroit,Miami,10/21/2018,Jerome Boger,10,93,6,43,4,50,12,7,2018
2405,Minnesota,N.Y. Jets,10/21/2018,Shawn Smith,14,126,6,55,8,71,15,7,2018
2406,Carolina,Philadelphia,10/21/2018,Clete Blakeman,9,113,5,78,4,35,12,7,2018
2407,Cleveland,Tampa Bay,10/21/2018,Shawn Hochuli,22,179,14,114,8,65,24,7,2018
2408,Dallas,Washington,10/21/2018,John Hussey,13,100,8,65,5,35,14,7,2018
2409,LA Rams,San Francisco,10/21/2018,Walt Anderson,3,20,1,10,2,10,6,7,2018
2410,N.Y. Giants,Atlanta,10/22/2018,Tony Corrente,9,87,4,58,5,29,11,7,2018
2411,Miami,Houston,10/25/2018,Shawn Smith,13,120,5,63,8,57,20,8,2018
2412,Philadelphia,Jacksonville,10/28/2018,John Hussey,9,81,4,36,5,45,11,8,2018
2413,Baltimore,Carolina,10/28/2018,Pete Morelli,13,98,9,68,4,30,13,8,2018
2414,N.Y. Jets,Chicago,10/28/2018,Clete Blakeman,10,70,8,45,2,25,15,8,2018
2415,Tampa Bay,Cincinnati,10/28/2018,Alex Kemp,15,121,11,75,4,46,22,8,2018
2416,Seattle,Detroit,10/28/2018,Walt Anderson,11,143,7,111,4,32,12,8,2018
2417,Denver,Kansas City,10/28/2018,Shawn Hochuli,17,133,10,83,7,50,26,8,2018
2418,Washington,N.Y. Giants,10/28/2018,Bill Vinovich,19,192,8,90,11,102,24,8,2018
2419,Cleveland,Pittsburgh,10/28/2018,Carl Cheffers,15,112,7,52,8,60,17,8,2018
2420,Indianapolis,Oakland,10/28/2018,John Parry,20,156,10,77,10,79,25,8,2018
2421,San Francisco,Arizona,10/28/2018,Brad Allen,14,121,5,59,9,62,16,8,2018
2422,Green Bay,LA Rams,10/28/2018,Ron Torbert,4,25,2,10,2,15,5,8,2018
2423,New Orleans,Minnesota,10/28/2018,Craig Wrolstad,13,118,7,64,6,54,14,8,2018
2424,New England,Buffalo,10/29/2018,Jerome Boger,11,84,5,33,6,51,16,8,2018
2425,Oakland,San Francisco,11/1/2018,Carl Cheffers,9,63,6,40,3,23,11,9,2018
2426,Pittsburgh,Baltimore,11/4/2018,Craig Wrolstad,13,128,8,103,5,25,18,9,2018
2427,Chicago,Buffalo,11/4/2018,Shawn Smith,24,292,14,129,10,163,25,9,2018
2428,Tampa Bay,Carolina,11/4/2018,Tony Corrente,17,133,8,49,9,84,18,9,2018
2429,Kansas City,Cleveland,11/4/2018,Ron Torbert,15,106,11,86,4,20,20,9,2018
2430,N.Y. Jets,Miami,11/4/2018,Walt Coleman,10,100,5,45,5,55,10,9,2018
2431,Detroit,Minnesota,11/4/2018,Pete Morelli,11,81,8,66,3,15,13,9,2018
2432,Atlanta,Washington,11/4/2018,Walt Anderson,17,197,7,50,10,147,20,9,2018
2433,Houston,Denver,11/4/2018,Clay Martin,15,110,7,60,8,50,16,9,2018
2434,LA Chargers,Seattle,11/4/2018,Shawn Hochuli,22,188,12,105,10,83,26,9,2018
2435,LA Rams,New Orleans,11/4/2018,Bill Vinovich,6,52,4,32,2,20,7,9,2018
2436,Green Bay,New England,11/4/2018,Brad Allen,12,93,7,63,5,30,16,9,2018
2437,Tennessee,Dallas,11/5/2018,Clete Blakeman,9,72,3,20,6,52,11,9,2018
2438,Carolina,Pittsburgh,11/8/2018,Walt Coleman,6,66,5,42,1,24,7,10,2018
2439,Detroit,Chicago,11/11/2018,Alex Kemp,12,87,6,41,6,46,15,10,2018
2440,New Orleans,Cincinnati,11/11/2018,Tony Corrente,5,31,1,5,4,26,6,10,2018
2441,Atlanta,Cleveland,11/11/2018,Pete Morelli,8,43,1,5,7,38,10,10,2018
2442,Miami,Green Bay,11/11/2018,Clay Martin,9,55,3,10,6,45,14,10,2018
2443,Jacksonville,Indianapolis,11/11/2018,Jerome Boger,15,106,8,61,7,45,18,10,2018
2444,Arizona,Kansas City,11/11/2018,Carl Cheffers,11,93,3,30,8,63,15,10,2018
2445,Buffalo,N.Y. Jets,11/11/2018,Ron Torbert,5,40,4,30,1,10,7,10,2018
2446,Washington,Tampa Bay,11/11/2018,Brad Allen,13,102,8,52,5,50,14,10,2018
2447,New England,Tennessee,11/11/2018,Bill Vinovich,8,66,4,31,4,35,10,10,2018
2448,LA Chargers,Oakland,11/11/2018,Craig Wrolstad,12,125,6,70,6,55,13,10,2018
2449,Seattle,LA Rams,11/11/2018,John Hussey,17,158,7,56,10,102,20,10,2018
2450,Dallas,Philadelphia,11/11/2018,John Parry,5,37,5,37,0,0,5,10,2018
2451,N.Y. Giants,San Francisco,11/12/2018,Shawn Hochuli,18,175,8,78,10,97,20,10,2018
2452,Green Bay,Seattle,11/15/2018,Tony Corrente,11,110,5,80,6,30,12,11,2018
2453,Dallas,Atlanta,11/18/2018,Craig Wrolstad,4,35,2,20,2,15,5,11,2018
2454,Cincinnati,Baltimore,11/18/2018,Walt Coleman,12,89,7,58,5,31,12,11,2018
2455,Minnesota,Chicago,11/18/2018,John Parry,9,96,4,50,5,46,11,11,2018
2456,Carolina,Detroit,11/18/2018,Clay Martin,3,20,2,15,1,5,7,11,2018
2457,Tennessee,Indianapolis,11/18/2018,John Hussey,15,172,8,112,7,60,16,11,2018
2458,Tampa Bay,N.Y. Giants,11/18/2018,Shawn Smith,12,100,4,40,8,60,12,11,2018
2459,Houston,Washington,11/18/2018,Alex Kemp,13,83,7,40,6,43,14,11,2018
2460,Oakland,Arizona,11/18/2018,Jerome Boger,11,82,4,20,7,62,12,11,2018
2461,Denver,LA Chargers,11/18/2018,Pete Morelli,21,163,7,43,14,120,23,11,2018
2462,Philadelphia,New Orleans,11/18/2018,Carl Cheffers,14,118,6,49,8,69,16,11,2018
2463,Pittsburgh,Jacksonville,11/18/2018,Walt Anderson,14,126,3,15,11,111,17,11,2018
2464,Kansas City,LA Rams,11/19/2018,Clete Blakeman,21,195,14,145,7,50,26,11,2018
2465,Chicago,Detroit,11/22/2018,Brad Allen,8,74,3,20,5,54,8,12,2018
2466,Washington,Dallas,11/22/2018,Ron Torbert,8,55,4,25,4,30,10,12,2018
2467,Atlanta,New Orleans,11/22/2018,John Hussey,5,45,2,26,3,19,8,12,2018
2468,Oakland,Baltimore,11/25/2018,Clay Martin,10,69,4,24,6,45,14,12,2018
2469,Jacksonville,Buffalo,11/25/2018,Walt Coleman,23,170,10,90,13,80,30,12,2018
2470,Seattle,Carolina,11/25/2018,Shawn Smith,7,66,4,36,3,30,9,12,2018
2471,Cleveland,Cincinnati,11/25/2018,Jerome Boger,20,157,7,61,13,96,23,12,2018
2472,Miami,Indianapolis,11/25/2018,Clete Blakeman,17,127,10,75,7,52,23,12,2018
2473,New England,N.Y. Jets,11/25/2018,Shawn Hochuli,19,152,11,105,8,47,20,12,2018
2474,N.Y. Giants,Philadelphia,11/25/2018,Walt Anderson,18,137,11,91,7,46,19,12,2018
2475,San Francisco,Tampa Bay,11/25/2018,John Parry,17,138,8,68,9,70,20,12,2018
2476,Arizona,LA Chargers,11/25/2018,Alex Kemp,7,65,3,35,4,30,11,12,2018
2477,Pittsburgh,Denver,11/25/2018,Tony Corrente,11,84,5,34,6,50,16,12,2018
2478,Green Bay,Minnesota,11/25/2018,Bill Vinovich,10,75,4,20,6,55,11,12,2018
2479,Tennessee,Houston,11/26/2018,Craig Wrolstad,10,103,7,50,3,53,12,12,2018
2480,New Orleans,Dallas,11/29/2018,Walt Anderson,13,128,5,48,8,80,17,13,2018
2481,Baltimore,Atlanta,12/2/2018,Brad Allen,17,170,9,88,8,82,20,13,2018
2482,Denver,Cincinnati,12/2/2018,Ron Torbert,19,160,7,60,12,100,22,13,2018
2483,LA Rams,Detroit,12/2/2018,John Parry,15,159,7,105,8,54,22,13,2018
2484,Arizona,Green Bay,12/2/2018,Pete Morelli,14,92,7,49,7,43,17,13,2018
2485,Cleveland,Houston,12/2/2018,Walt Coleman,11,122,6,45,5,77,13,13,2018
2486,Indianapolis,Jacksonville,12/2/2018,Alex Kemp,14,139,6,65,8,74,17,13,2018
2487,Buffalo,Miami,12/2/2018,Shawn Hochuli,21,209,13,120,8,89,28,13,2018
2488,Chicago,N.Y. Giants,12/2/2018,Clay Martin,20,165,8,58,12,107,23,13,2018
2489,LA Chargers,Pittsburgh,12/2/2018,Bill Vinovich,12,139,5,80,7,59,14,13,2018
2490,Carolina,Tampa Bay,12/2/2018,Carl Cheffers,16,173,7,104,9,69,17,13,2018
2491,Kansas City,Oakland,12/2/2018,Shawn Smith,19,168,11,94,8,74,25,13,2018
2492,N.Y. Jets,Tennessee,12/2/2018,Jerome Boger,19,171,11,96,8,75,23,13,2018
2493,Minnesota,New England,12/2/2018,Craig Wrolstad,12,115,5,55,7,60,12,13,2018
2494,San Francisco,Seattle,12/2/2018,Clete Blakeman,23,228,14,133,9,95,26,13,2018
2495,Washington,Philadelphia,12/3/2018,Tony Corrente,15,107,10,69,5,38,18,13,2018
2496,Jacksonville,Tennessee,12/6/2018,John Parry,10,97,7,67,3,30,13,14,2018
2497,N.Y. Jets,Buffalo,12/9/2018,Alex Kemp,14,140,7,93,7,47,16,14,2018
2498,LA Rams,Chicago,12/9/2018,Craig Wrolstad,15,102,9,57,6,45,15,14,2018
2499,Carolina,Cleveland,12/9/2018,Walt Anderson,17,120,10,68,7,52,22,14,2018
2500,Atlanta,Green Bay,12/9/2018,Walt Coleman,19,138,13,101,6,37,22,14,2018
2501,Indianapolis,Houston,12/9/2018,Bill Vinovich,16,94,9,59,7,35,19,14,2018
2502,Baltimore,Kansas City,12/9/2018,Tony Corrente,18,165,11,112,7,53,22,14,2018
2503,New England,Miami,12/9/2018,Pete Morelli,12,111,5,30,7,81,15,14,2018
2504,New Orleans,Tampa Bay,12/9/2018,Jerome Boger,16,135,6,51,10,84,20,14,2018
2505,N.Y. Giants,Washington,12/9/2018,Carl Cheffers,17,153,2,18,15,135,20,14,2018
2506,Cincinnati,LA Chargers,12/9/2018,John Hussey,12,72,6,34,6,38,13,14,2018
2507,Denver,San Francisco,12/9/2018,Shawn Smith,22,149,11,62,11,87,24,14,2018
2508,Detroit,Arizona,12/9/2018,Shawn Hochuli,15,151,7,68,8,83,22,14,2018
2509,Philadelphia,Dallas,12/9/2018,Clete Blakeman,16,160,5,49,11,111,19,14,2018
2510,Pittsburgh,Oakland,12/9/2018,Ron Torbert,15,144,2,14,13,130,15,14,2018
2511,Minnesota,Seattle,12/10/2018,Brad Allen,8,96,4,51,4,45,10,14,2018
2512,LA Chargers,Kansas City,12/13/2018,Walt Anderson,17,116,7,50,10,66,21,15,2018
2513,Houston,N.Y. Jets,12/15/2018,Brad Allen,14,103,5,43,9,60,16,15,2018
2514,Cleveland,Denver,12/15/2018,Clay Martin,14,126,6,75,8,51,20,15,2018
2515,Arizona,Atlanta,12/16/2018,Shawn Smith,14,125,8,75,6,50,18,15,2018
2516,Tampa Bay,Baltimore,12/16/2018,Ron Torbert,14,128,6,58,8,70,14,15,2018
2517,Detroit,Buffalo,12/16/2018,Jerome Boger,7,101,4,81,3,20,14,15,2018
2518,Green Bay,Chicago,12/16/2018,John Hussey,11,72,7,48,4,24,12,15,2018
2519,Oakland,Cincinnati,12/16/2018,Alex Kemp,17,175,8,90,9,85,19,15,2018
2520,Dallas,Indianapolis,12/16/2018,Carl Cheffers,15,129,9,74,6,55,17,15,2018
2521,Washington,Jacksonville,12/16/2018,Clete Blakeman,14,103,6,48,8,55,19,15,2018
2522,Miami,Minnesota,12/16/2018,Walt Coleman,14,94,8,49,6,45,15,15,2018
2523,Tennessee,N.Y. Giants,12/16/2018,Shawn Hochuli,14,93,4,35,10,58,17,15,2018
2524,Seattle,San Francisco,12/16/2018,Pete Morelli,22,214,14,148,8,66,23,15,2018
2525,New England,Pittsburgh,12/16/2018,John Parry,18,146,14,106,4,40,19,15,2018
2526,Philadelphia,LA Rams,12/16/2018,Bill Vinovich,11,99,6,49,5,50,13,15,2018
2527,New Orleans,Carolina,12/17/2018,Tony Corrente,13,128,9,80,4,48,18,15,2018
2528,Washington,Tennessee,12/22/2018,John Hussey,10,59,8,49,2,10,11,16,2018
2529,Baltimore,LA Chargers,12/22/2018,Clete Blakeman,12,109,4,40,8,69,13,16,2018
2530,N.Y. Giants,Indianapolis,12/23/2018,Brad Allen,12,53,6,24,6,29,15,16,2018
2531,Jacksonville,Miami,12/23/2018,Clay Martin,20,192,10,97,10,95,25,16,2018
2532,Atlanta,Carolina,12/23/2018,Pete Morelli,14,127,4,41,10,86,15,16,2018
2533,Cincinnati,Cleveland,12/23/2018,Tony Corrente,9,72,3,15,6,57,10,16,2018
2534,Tampa Bay,Dallas,12/23/2018,Shawn Hochuli,19,139,9,72,10,67,19,16,2018
2535,Minnesota,Detroit,12/23/2018,Walt Anderson,18,133,11,78,7,55,21,16,2018
2536,Buffalo,New England,12/23/2018,Shawn Smith,8,78,3,29,5,49,8,16,2018
2537,Green Bay,N.Y. Jets,12/23/2018,Ron Torbert,26,258,10,86,16,172,29,16,2018
2538,Houston,Philadelphia,12/23/2018,John Parry,21,166,10,61,11,105,21,16,2018
2539,LA Rams,Arizona,12/23/2018,Walt Coleman,13,120,6,66,7,54,15,16,2018
2540,Chicago,San Francisco,12/23/2018,Alex Kemp,10,75,4,30,6,45,18,16,2018
2541,Pittsburgh,New Orleans,12/23/2018,Craig Wrolstad,15,170,6,79,9,91,17,16,2018
2542,Kansas City,Seattle,12/23/2018,Bill Vinovich,11,96,8,76,3,20,13,16,2018
2543,Denver,Oakland,12/24/2018,Carl Cheffers,17,141,11,91,6,50,18,16,2018
2544,Cleveland,Baltimore,12/30/2018,Shawn Smith,14,100,4,35,10,65,14,17,2018
2545,Miami,Buffalo,12/30/2018,John Hussey,7,59,4,35,3,24,13,17,2018
2546,Detroit,Green Bay,12/30/2018,Alex Kemp,8,72,3,34,5,38,8,17,2018
2547,Jacksonville,Houston,12/30/2018,Pete Morelli,10,83,8,68,2,15,10,17,2018
2548,Oakland,Kansas City,12/30/2018,Shawn Hochuli,8,72,4,22,4,50,8,17,2018
2549,Chicago,Minnesota,12/30/2018,Clete Blakeman,14,132,11,102,3,30,16,17,2018
2550,N.Y. Jets,New England,12/30/2018,Walt Coleman,8,60,4,30,4,30,9,17,2018
2551,Carolina,New Orleans,12/30/2018,Bill Vinovich,8,104,2,10,6,94,8,17,2018
2552,Dallas,N.Y. Giants,12/30/2018,Clay Martin,17,124,6,46,11,78,17,17,2018
2553,Cincinnati,Pittsburgh,12/30/2018,Carl Cheffers,18,155,9,85,9,70,19,17,2018
2554,Atlanta,Tampa Bay,12/30/2018,Brad Allen,12,115,9,85,3,30,13,17,2018
2555,Indianapolis,Tennessee,12/30/2018,Walt Anderson,21,171,12,96,9,75,24,17,2018
2556,Philadelphia,Washington,12/30/2018,Craig Wrolstad,7,40,5,25,2,15,8,17,2018
2557,LA Chargers,Denver,12/30/2018,John Parry,17,150,6,51,11,99,22,17,2018
2558,San Francisco,LA Rams,12/30/2018,Jerome Boger,11,98,5,41,6,57,14,17,2018
2559,Arizona,Seattle,12/30/2018,Ron Torbert,4,30,3,20,1,10,4,17,2018
2560,Green Bay,Chicago,9/5/2019,Tony Corrente,20,178,10,71,10,107,24,1,2019
2561,LA Rams,Carolina,9/8/2019,Shawn Hochuli,11,89,5,43,6,46,16,1,2019
2562,Tennessee,Cleveland,9/8/2019,Brad Allen,24,236,6,54,18,182,28,1,2019
2563,Kansas City,Jacksonville,9/8/2019,Carl Cheffers,15,126,5,55,10,71,25,1,2019
2564,Baltimore,Miami,9/8/2019,Jerome Boger,13,104,4,40,9,64,16,1,2019
2565,Atlanta,Minnesota,9/8/2019,Bill Vinovich,20,178,9,78,11,100,23,1,2019
2566,Buffalo,N.Y. Jets,9/8/2019,Clay Martin,15,122,7,55,8,67,18,1,2019
2567,Washington,Philadelphia,9/8/2019,Ron Torbert,18,151,12,96,6,55,20,1,2019
2568,Indianapolis,LA Chargers,9/8/2019,Shawn Smith,6,30,3,10,3,20,6,1,2019
2569,Cincinnati,Seattle,9/8/2019,Brad Rogers,15,112,7,57,8,55,19,1,2019
2570,Detroit,Arizona,9/8/2019,Scott Novak,16,94,9,59,7,35,23,1,2019
2571,N.Y. Giants,Dallas,9/8/2019,Walt Anderson,14,117,8,70,6,47,16,1,2019
2572,San Francisco,Tampa Bay,9/8/2019,Alex Kemp,19,174,11,87,8,87,23,1,2019
2573,Pittsburgh,New England,9/8/2019,Clete Blakeman,13,109,6,54,7,55,14,1,2019
2574,Houston,New Orleans,9/9/2019,John Hussey,15,117,8,69,7,48,18,1,2019
2575,Denver,Oakland,9/9/2019,Craig Wrolstad,15,106,6,44,9,62,17,1,2019
2576,Tampa Bay,Carolina,9/12/2019,Jerome Boger,17,116,12,66,5,50,19,2,2019
2577,Arizona,Baltimore,9/15/2019,Ron Torbert,18,132,8,70,10,62,20,2,2019
2578,San Francisco,Cincinnati,9/15/2019,Tony Corrente,16,135,9,75,7,60,20,2,2019
2579,LA Chargers,Detroit,9/15/2019,Craig Wrolstad,17,141,9,70,8,71,24,2,2019
2580,Minnesota,Green Bay,9/15/2019,John Hussey,14,135,8,100,6,35,20,2,2019
2581,Jacksonville,Houston,9/15/2019,Scott Novak,16,117,9,70,7,47,17,2,2019
2582,New England,Miami,9/15/2019,Bill Vinovich,9,76,5,54,4,22,14,2,2019
2583,Buffalo,N.Y. Giants,9/15/2019,Shawn Smith,16,105,9,65,7,40,18,2,2019
2584,Seattle,Pittsburgh,9/15/2019,Carl Cheffers,15,171,10,93,5,78,20,2,2019
2585,Indianapolis,Tennessee,9/15/2019,Clete Blakeman,13,140,8,65,5,75,16,2,2019
2586,Dallas,Washington,9/15/2019,Shawn Hochuli,14,111,8,67,6,44,18,2,2019
2587,Kansas City,Oakland,9/15/2019,Clay Martin,17,166,10,114,7,52,21,2,2019
2588,Chicago,Denver,9/15/2019,Adrian Hill,17,150,7,69,10,81,20,2,2019
2589,New Orleans,LA Rams,9/15/2019,Walt Anderson,19,152,11,87,8,65,22,2,2019
2590,Philadelphia,Atlanta,9/15/2019,Brad Allen,17,118,7,60,10,58,20,2,2019
2591,Cleveland,N.Y. Jets,9/16/2019,Alex Kemp,21,174,9,85,12,89,27,2,2019
2592,Tennessee,Jacksonville,9/19/2019,Shawn Hochuli,13,131,9,101,4,30,20,3,2019
2593,Cincinnati,Buffalo,9/22/2019,Clete Blakeman,15,109,8,54,7,55,16,3,2019
2594,Miami,Dallas,9/22/2019,Adrian Hill,13,135,5,35,8,100,17,3,2019
2595,Denver,Green Bay,9/22/2019,Brad Rogers,10,80,3,27,7,53,13,3,2019
2596,Atlanta,Indianapolis,9/22/2019,Alex Kemp,20,167,16,128,4,39,22,3,2019
2597,Baltimore,Kansas City,9/22/2019,John Hussey,11,91,7,60,4,31,13,3,2019
2598,Oakland,Minnesota,9/22/2019,Jerome Boger,13,143,7,84,6,59,14,3,2019
2599,N.Y. Jets,New England,9/22/2019,Carl Cheffers,13,137,5,67,8,70,15,3,2019
2600,Detroit,Philadelphia,9/22/2019,Tony Corrente,13,91,9,61,4,30,14,3,2019
2601,Carolina,Arizona,9/22/2019,Craig Wrolstad,10,87,3,35,7,52,15,3,2019
2602,N.Y. Giants,Tampa Bay,9/22/2019,Bill Vinovich,10,89,6,59,4,30,13,3,2019
2603,Houston,LA Chargers,9/22/2019,Clay Martin,13,134,6,65,7,69,18,3,2019
2604,New Orleans,Seattle,9/22/2019,Ron Torbert,18,123,11,70,7,53,19,3,2019
2605,Pittsburgh,San Francisco,9/22/2019,Scott Novak,11,113,6,42,5,71,13,3,2019
2606,LA Rams,Cleveland,9/22/2019,Shawn Smith,15,110,7,50,8,60,20,3,2019
2607,Chicago,Washington,9/23/2019,Walt Anderson,18,120,9,59,9,61,23,3,2019
2608,Philadelphia,Green Bay,9/26/2019,Clay Martin,14,143,9,93,5,50,15,4,2019
2609,Tennessee,Atlanta,9/29/2019,John Hussey,12,127,5,77,7,50,15,4,2019
2610,Cleveland,Baltimore,9/29/2019,Shawn Hochuli,9,56,6,41,3,15,15,4,2019
2611,New England,Buffalo,9/29/2019,Craig Wrolstad,16,134,8,58,8,76,23,4,2019
2612,Kansas City,Detroit,9/29/2019,Walt Anderson,15,99,7,51,8,48,19,4,2019
2613,Carolina,Houston,9/29/2019,Adrian Hill,13,116,6,35,7,81,16,4,2019
2614,Oakland,Indianapolis,9/29/2019,Scott Novak,16,115,11,80,5,35,22,4,2019
2615,LA Chargers,Miami,9/29/2019,Tony Corrente,15,142,10,89,5,53,18,4,2019
2616,Washington,N.Y. Giants,9/29/2019,Alex Kemp,17,103,12,58,5,45,22,4,2019
2617,Seattle,Arizona,9/29/2019,Shawn Smith,14,109,7,65,7,44,16,4,2019
2618,Tampa Bay,LA Rams,9/29/2019,Brad Rogers,25,205,12,99,13,106,28,4,2019
2619,Minnesota,Chicago,9/29/2019,Brad Allen,14,118,7,68,7,50,17,4,2019
2620,Jacksonville,Denver,9/29/2019,Ron Torbert,17,152,12,104,5,48,21,4,2019
2621,Dallas,New Orleans,9/29/2019,Carl Cheffers,15,144,6,64,9,80,17,4,2019
2622,Cincinnati,Pittsburgh,9/30/2019,Bill Vinovich,12,97,8,60,4,37,13,4,2019
2623,LA Rams,Seattle,10/3/2019,Scott Novak,11,90,6,45,5,45,17,5,2019
2624,Jacksonville,Carolina,10/6/2019,Alex Kemp,17,154,9,84,8,70,21,5,2019
2625,Arizona,Cincinnati,10/6/2019,John Hussey,19,156,12,96,7,60,23,5,2019
2626,Atlanta,Houston,10/6/2019,Shawn Smith,16,152,7,63,9,89,17,5,2019
2627,Tampa Bay,New Orleans,10/6/2019,Brad Allen,10,70,4,30,6,40,13,5,2019
2628,Minnesota,N.Y. Giants,10/6/2019,Clete Blakeman,17,157,12,112,5,45,22,5,2019
2629,Chicago,Oakland,10/6/2019,Tony Corrente,16,144,10,75,6,69,21,5,2019
2630,N.Y. Jets,Philadelphia,10/6/2019,Adrian Hill,18,128,9,52,9,76,20,5,2019
2631,Baltimore,Pittsburgh,10/6/2019,Walt Anderson,22,168,11,92,11,76,25,5,2019
2632,Buffalo,Tennessee,10/6/2019,Brad Rogers,19,138,11,78,8,60,20,5,2019
2633,New England,Washington,10/6/2019,Clay Martin,13,127,7,55,6,72,16,5,2019
2634,Denver,LA Chargers,10/6/2019,Shawn Hochuli,16,165,12,122,4,43,18,5,2019
2635,Green Bay,Dallas,10/6/2019,Ron Torbert,20,202,9,78,11,124,24,5,2019
2636,Indianapolis,Kansas City,10/6/2019,Craig Wrolstad,18,175,7,50,11,125,23,5,2019
2637,Cleveland,San Francisco,10/7/2019,Jerome Boger,11,89,7,55,4,34,12,5,2019
2638,N.Y. Giants,New England,10/10/2019,Brad Allen,8,60,5,40,3,20,10,6,2019
2639,Carolina,Tampa Bay,10/13/2019,Walt Anderson,12,100,3,30,9,70,14,6,2019
2640,Cincinnati,Baltimore,10/13/2019,Clay Martin,14,101,4,20,10,81,17,6,2019
2641,Seattle,Cleveland,10/13/2019,Adrian Hill,19,148,10,65,9,83,20,6,2019
2642,New Orleans,Jacksonville,10/13/2019,Jerome Boger,5,50,3,35,2,15,11,6,2019
2643,Houston,Kansas City,10/13/2019,Shawn Hochuli,21,149,10,70,11,79,29,6,2019
2644,Washington,Miami,10/13/2019,Shawn Smith,11,101,6,56,5,45,12,6,2019
2645,Philadelphia,Minnesota,10/13/2019,Scott Novak,11,79,7,49,4,30,12,6,2019
2646,Atlanta,Arizona,10/13/2019,Carl Cheffers,16,129,8,72,8,57,20,6,2019
2647,San Francisco,LA Rams,10/13/2019,Bill Vinovich,12,89,4,30,8,59,14,6,2019
2648,Tennessee,Denver,10/13/2019,Alex Kemp,14,91,6,40,8,51,17,6,2019
2649,Dallas,N.Y. Jets,10/13/2019,Brad Rogers,17,173,9,68,8,105,21,6,2019
2650,Pittsburgh,LA Chargers,10/13/2019,John Hussey,14,119,6,45,8,74,15,6,2019
2651,Detroit,Green Bay,10/14/2019,Clete Blakeman,14,98,8,50,6,48,14,6,2019
2652,Kansas City,Denver,10/17/2019,Shawn Smith,10,79,6,46,4,33,12,7,2019
2653,LA Rams,Atlanta,10/20/2019,Ron Torbert,10,72,5,24,5,48,13,7,2019
2654,Miami,Buffalo,10/20/2019,Carl Cheffers,15,138,6,55,9,83,17,7,2019
2655,Jacksonville,Cincinnati,10/20/2019,Craig Wrolstad,17,180,11,130,6,50,21,7,2019
2656,Minnesota,Detroit,10/20/2019,Brad Rogers,14,128,6,61,8,67,19,7,2019
2657,Oakland,Green Bay,10/20/2019,Alex Kemp,11,117,8,97,3,20,12,7,2019
2658,Houston,Indianapolis,10/20/2019,Tony Corrente,16,99,10,54,6,45,21,7,2019
2659,Arizona,N.Y. Giants,10/20/2019,Adrian Hill,16,160,10,85,6,75,19,7,2019
2660,San Francisco,Washington,10/20/2019,Clete Blakeman,9,67,2,20,7,47,10,7,2019
2661,LA Chargers,Tennessee,10/20/2019,Bill Vinovich,11,83,4,29,7,54,13,7,2019
2662,New Orleans,Chicago,10/20/2019,Scott Novak,7,45,4,35,3,10,11,7,2019
2663,Baltimore,Seattle,10/20/2019,Brad Allen,10,93,8,75,2,18,14,7,2019
2664,Philadelphia,Dallas,10/20/2019,Jerome Boger,11,105,5,40,6,65,16,7,2019
2665,New England,N.Y. Jets,10/21/2019,Shawn Hochuli,15,152,7,92,8,60,17,7,2019
2666,Washington,Minnesota,10/24/2019,Carl Cheffers,11,120,4,46,7,74,16,8,2019
2667,Seattle,Atlanta,10/27/2019,Clete Blakeman,14,100,9,60,5,40,19,8,2019
2668,Philadelphia,Buffalo,10/27/2019,John Hussey,12,101,4,44,8,57,16,8,2019
2669,LA Chargers,Chicago,10/27/2019,Brad Rogers,13,95,8,53,5,42,16,8,2019
2670,N.Y. Giants,Detroit,10/27/2019,Scott Novak,12,119,5,44,7,75,13,8,2019
2671,Oakland,Houston,10/27/2019,Craig Wrolstad,18,150,11,100,7,50,19,8,2019
2672,N.Y. Jets,Jacksonville,10/27/2019,Brad Allen,19,153,10,83,9,70,20,8,2019
2673,Cincinnati,LA Rams,10/27/2019,Jerome Boger,15,99,6,40,9,59,18,8,2019
2674,Arizona,New Orleans,10/27/2019,Clay Martin,7,50,5,35,2,15,8,8,2019
2675,Tampa Bay,Tennessee,10/27/2019,Adrian Hill,15,164,9,87,6,77,17,8,2019
2676,Carolina,San Francisco,10/27/2019,Shawn Smith,13,101,9,70,4,31,16,8,2019
2677,Denver,Indianapolis,10/27/2019,Walt Anderson,20,191,10,88,10,103,23,8,2019
2678,Cleveland,New England,10/27/2019,Tony Corrente,17,117,13,85,4,32,19,8,2019
2679,Green Bay,Kansas City,10/27/2019,Bill Vinovich,7,55,4,25,3,30,8,8,2019
2680,Miami,Pittsburgh,10/28/2019,Ron Torbert,14,115,5,45,9,70,18,8,2019
2681,San Francisco,Arizona,10/31/2019,Brad Rogers,17,140,8,75,9,65,19,9,2019
2682,Houston,Jacksonville,11/3/2019,Clete Blakeman,11,94,7,60,4,34,13,9,2019
2683,Washington,Buffalo,11/3/2019,Tony Corrente,5,35,3,15,2,20,9,9,2019
2684,Tennessee,Carolina,11/3/2019,Ron Torbert,17,176,11,99,6,77,22,9,2019
2685,Minnesota,Kansas City,11/3/2019,Alex Kemp,7,50,3,25,4,25,10,9,2019
2686,N.Y. Jets,Miami,11/3/2019,Walt Anderson,16,156,10,105,6,51,19,9,2019
2687,Chicago,Philadelphia,11/3/2019,Craig Wrolstad,17,145,9,70,8,75,19,9,2019
2688,Indianapolis,Pittsburgh,11/3/2019,Brad Allen,12,159,7,89,5,70,14,9,2019
2689,Detroit,Oakland,11/3/2019,Shawn Hochuli,15,131,5,35,10,96,19,9,2019
2690,Tampa Bay,Seattle,11/3/2019,John Hussey,15,127,11,82,4,45,15,9,2019
2691,Cleveland,Denver,11/3/2019,Bill Vinovich,12,95,5,40,7,55,14,9,2019
2692,Green Bay,LA Chargers,11/3/2019,Adrian Hill,13,90,8,45,5,45,15,9,2019
2693,New England,Baltimore,11/3/2019,Carl Cheffers,11,82,7,48,4,34,12,9,2019
2694,Dallas,N.Y. Giants,11/4/2019,Clay Martin,18,175,10,104,8,71,22,9,2019
2695,LA Chargers,Oakland,11/7/2019,Walt Anderson,20,167,8,70,12,97,27,10,2019
2696,Detroit,Chicago,11/10/2019,Carl Cheffers,15,133,8,76,7,57,20,10,2019
2697,Baltimore,Cincinnati,11/10/2019,Scott Novak,6,40,5,35,1,5,8,10,2019
2698,Buffalo,Cleveland,11/10/2019,Ron Torbert,11,110,7,40,4,70,13,10,2019
2699,Carolina,Green Bay,11/10/2019,Jerome Boger,15,110,5,46,10,64,21,10,2019
2700,Atlanta,New Orleans,11/10/2019,Brad Allen,19,138,7,48,12,90,21,10,2019
2701,N.Y. Giants,N.Y. Jets,11/10/2019,John Hussey,13,116,6,62,7,54,13,10,2019
2702,Arizona,Tampa Bay,11/10/2019,Craig Wrolstad,20,181,11,87,9,94,21,10,2019
2703,Kansas City,Tennessee,11/10/2019,Tony Corrente,17,144,9,80,8,64,19,10,2019
2704,Miami,Indianapolis,11/10/2019,Clay Martin,7,55,4,30,3,25,11,10,2019
2705,LA Rams,Pittsburgh,11/10/2019,Shawn Smith,23,197,10,95,13,102,27,10,2019
2706,Minnesota,Dallas,11/10/2019,Shawn Hochuli,10,74,5,35,5,39,13,10,2019
2707,Seattle,San Francisco,11/11/2019,Alex Kemp,14,115,9,75,5,40,14,10,2019
2708,Pittsburgh,Cleveland,11/14/2019,Clete Blakeman,14,162,6,41,8,121,23,11,2019
2709,Houston,Baltimore,11/17/2019,Alex Kemp,13,125,5,60,8,65,18,11,2019
2710,Atlanta,Carolina,11/17/2019,Adrian Hill,11,88,3,20,8,68,15,11,2019
2711,Dallas,Detroit,11/17/2019,Tony Corrente,17,134,6,45,11,89,21,11,2019
2712,Jacksonville,Indianapolis,11/17/2019,Shawn Hochuli,11,101,8,81,3,20,13,11,2019
2713,Buffalo,Miami,11/17/2019,Scott Novak,11,94,5,50,6,44,16,11,2019
2714,Denver,Minnesota,11/17/2019,Clay Martin,11,84,6,35,5,49,16,11,2019
2715,New Orleans,Tampa Bay,11/17/2019,Brad Rogers,16,131,9,76,7,55,18,11,2019
2716,N.Y. Jets,Washington,11/17/2019,Jerome Boger,17,121,6,55,11,66,19,11,2019
2717,Arizona,San Francisco,11/17/2019,Walt Anderson,20,231,10,104,10,127,21,11,2019
2718,Cincinnati,Oakland,11/17/2019,Shawn Smith,11,82,4,40,7,42,15,11,2019
2719,New England,Philadelphia,11/17/2019,Bill Vinovich,13,128,6,89,7,39,14,11,2019
2720,Chicago,LA Rams,11/17/2019,John Hussey,8,59,2,25,6,34,12,11,2019
2721,Kansas City,LA Chargers,11/18/2019,Brad Allen,17,162,8,102,9,60,17,11,2019
2722,Indianapolis,Houston,11/21/2019,Ron Torbert,7,56,3,29,4,27,11,12,2019
2723,Tampa Bay,Atlanta,11/24/2019,Clay Martin,15,111,8,51,7,60,18,12,2019
2724,Denver,Buffalo,11/24/2019,Jerome Boger,19,160,7,70,12,90,19,12,2019
2725,N.Y. Giants,Chicago,11/24/2019,Shawn Hochuli,12,88,6,35,6,53,17,12,2019
2726,Pittsburgh,Cincinnati,11/24/2019,Adrian Hill,17,155,10,76,7,79,18,12,2019
2727,Miami,Cleveland,11/24/2019,Brad Rogers,15,164,8,94,7,70,20,12,2019
2728,Carolina,New Orleans,11/24/2019,Alex Kemp,15,148,3,25,12,123,22,12,2019
2729,Oakland,N.Y. Jets,11/24/2019,Clete Blakeman,8,72,4,35,4,37,8,12,2019
2730,Detroit,Washington,11/24/2019,Bill Vinovich,14,128,6,65,8,63,15,12,2019
2731,Jacksonville,Tennessee,11/24/2019,Shawn Smith,17,158,11,104,6,54,18,12,2019
2732,Dallas,New England,11/24/2019,Scott Novak,13,106,7,50,6,56,14,12,2019
2733,Green Bay,San Francisco,11/24/2019,Carl Cheffers,14,128,5,50,9,78,16,12,2019
2734,Seattle,Philadelphia,11/24/2019,Walt Anderson,14,105,12,90,2,15,16,12,2019
2735,Baltimore,LA Rams,11/25/2019,Craig Wrolstad,16,122,8,66,8,56,19,12,2019
2736,Chicago,Detroit,11/28/2019,Jerome Boger,19,174,10,89,9,85,26,13,2019
2737,Buffalo,Dallas,11/28/2019,Bill Vinovich,12,119,7,53,5,66,15,13,2019
2738,New Orleans,Atlanta,11/28/2019,Shawn Smith,13,139,9,121,4,18,15,13,2019
2739,San Francisco,Baltimore,12/1/2019,Brad Allen,9,77,6,54,3,23,10,13,2019
2740,Washington,Carolina,12/1/2019,Scott Novak,11,108,6,65,5,43,11,13,2019
2741,N.Y. Jets,Cincinnati,12/1/2019,Ron Torbert,12,121,10,106,2,15,12,13,2019
2742,Tennessee,Indianapolis,12/1/2019,Carl Cheffers,9,73,3,33,6,40,10,13,2019
2743,Tampa Bay,Jacksonville,12/1/2019,Walt Anderson,24,169,8,44,16,125,26,13,2019
2744,Oakland,Kansas City,12/1/2019,John Hussey,12,99,12,99,0,0,15,13,2019
2745,Philadelphia,Miami,12/1/2019,Adrian Hill,17,150,10,91,7,59,21,13,2019
2746,Green Bay,N.Y. Giants,12/1/2019,Craig Wrolstad,11,85,7,54,4,31,14,13,2019
2747,LA Rams,Arizona,12/1/2019,Alex Kemp,10,88,8,81,2,7,12,13,2019
2748,LA Chargers,Denver,12/1/2019,Brad Rogers,10,107,7,82,3,25,13,13,2019
2749,Cleveland,Pittsburgh,12/1/2019,Clay Martin,15,99,5,34,10,65,18,13,2019
2750,New England,Houston,12/1/2019,Tony Corrente,16,139,8,60,8,79,18,13,2019
2751,Minnesota,Seattle,12/2/2019,Clete Blakeman,4,60,3,30,1,30,4,13,2019
2752,Dallas,Chicago,12/5/2019,Brad Rogers,10,82,6,52,4,30,10,14,2019
2753,Carolina,Atlanta,12/8/2019,Clete Blakeman,13,102,7,44,6,58,14,14,2019
2754,Baltimore,Buffalo,12/8/2019,Shawn Smith,14,148,9,99,5,49,18,14,2019
2755,Cincinnati,Cleveland,12/8/2019,Carl Cheffers,14,129,8,99,6,30,16,14,2019
2756,Washington,Green Bay,12/8/2019,Clay Martin,8,59,3,25,5,34,8,14,2019
2757,Denver,Houston,12/8/2019,Adrian Hill,16,94,7,50,9,44,16,14,2019
2758,Detroit,Minnesota,12/8/2019,Walt Anderson,12,83,4,28,8,55,15,14,2019
2759,San Francisco,New Orleans,12/8/2019,John Hussey,15,117,10,67,5,50,16,14,2019
2760,Miami,N.Y. Jets,12/8/2019,Craig Wrolstad,10,136,5,48,5,88,12,14,2019
2761,Indianapolis,Tampa Bay,12/8/2019,Tony Corrente,9,139,3,35,6,104,14,14,2019
2762,LA Chargers,Jacksonville,12/8/2019,Bill Vinovich,16,166,6,65,10,101,16,14,2019
2763,Pittsburgh,Arizona,12/8/2019,Ron Torbert,11,95,4,20,7,75,11,14,2019
2764,Kansas City,New England,12/8/2019,Jerome Boger,15,161,10,136,5,25,20,14,2019
2765,Tennessee,Oakland,12/8/2019,Brad Allen,7,41,4,21,3,20,9,14,2019
2766,Seattle,LA Rams,12/8/2019,Shawn Hochuli,11,84,8,64,3,20,12,14,2019
2767,N.Y. Giants,Philadelphia,12/9/2019,Scott Novak,11,84,7,54,4,30,12,14,2019
2768,N.Y. Jets,Baltimore,12/12/2019,John Hussey,14,129,8,94,6,35,15,15,2019
2769,Seattle,Carolina,12/15/2019,Carl Cheffers,7,55,5,40,2,15,10,15,2019
2770,New England,Cincinnati,12/15/2019,Alex Kemp,9,55,4,30,5,25,12,15,2019
2771,Tampa Bay,Detroit,12/15/2019,Adrian Hill,11,80,9,70,2,10,12,15,2019
2772,Chicago,Green Bay,12/15/2019,Scott Novak,8,65,4,35,4,30,9,15,2019
2773,Denver,Kansas City,12/15/2019,Clete Blakeman,12,117,7,72,5,45,14,15,2019
2774,Miami,N.Y. Giants,12/15/2019,Jerome Boger,11,74,7,42,4,32,15,15,2019
2775,Buffalo,Pittsburgh,12/15/2019,Tony Corrente,14,100,8,70,6,30,16,15,2019
2776,Houston,Tennessee,12/15/2019,Bill Vinovich,9,57,5,27,4,30,13,15,2019
2777,Philadelphia,Washington,12/15/2019,Shawn Smith,12,114,7,54,5,60,15,15,2019
2778,Cleveland,Arizona,12/15/2019,Brad Allen,11,89,6,55,5,34,13,15,2019
2779,Jacksonville,Oakland,12/15/2019,Brad Rogers,14,138,8,87,6,51,14,15,2019
2780,LA Rams,Dallas,12/15/2019,Walt Anderson,9,45,5,29,4,16,12,15,2019
2781,Atlanta,San Francisco,12/15/2019,Craig Wrolstad,18,165,11,98,7,67,19,15,2019
2782,Minnesota,LA Chargers,12/15/2019,Ron Torbert,10,89,5,41,5,48,10,15,2019
2783,Indianapolis,New Orleans,12/16/2019,Shawn Hochuli,13,101,7,49,6,52,14,15,2019
2784,Houston,Tampa Bay,12/21/2019,Scott Novak,10,80,4,35,6,45,12,16,2019
2785,Buffalo,New England,12/21/2019,John Hussey,10,76,7,46,3,30,12,16,2019
2786,LA Rams,San Francisco,12/21/2019,Clete Blakeman,10,69,7,43,3,26,11,16,2019
2787,Detroit,Denver,12/22/2019,Craig Wrolstad,13,118,7,68,6,50,14,16,2019
2788,Oakland,LA Chargers,12/22/2019,Clay Martin,7,62,5,47,2,15,8,16,2019
2789,Jacksonville,Atlanta,12/22/2019,Adrian Hill,15,100,6,36,9,64,17,16,2019
2790,Baltimore,Cleveland,12/22/2019,Alex Kemp,14,112,7,50,7,62,15,16,2019
2791,Carolina,Indianapolis,12/22/2019,Walt Anderson,6,46,6,46,0,0,8,16,2019
2792,Cincinnati,Miami,12/22/2019,Brad Allen,16,124,10,77,6,47,19,16,2019
2793,Pittsburgh,N.Y. Jets,12/22/2019,Shawn Hochuli,7,64,4,34,3,30,9,16,2019
2794,New Orleans,Tennessee,12/22/2019,Jerome Boger,17,126,11,70,6,56,21,16,2019
2795,N.Y. Giants,Washington,12/22/2019,Ron Torbert,10,84,4,33,6,51,12,16,2019
2796,Dallas,Philadelphia,12/22/2019,Tony Corrente,6,50,2,20,4,30,9,16,2019
2797,Arizona,Seattle,12/22/2019,Brad Rogers,12,102,5,47,7,55,12,16,2019
2798,Kansas City,Chicago,12/22/2019,Carl Cheffers,16,121,9,71,7,50,19,16,2019
2799,Green Bay,Minnesota,12/23/2019,Bill Vinovich,5,50,2,20,3,30,6,16,2019
2800,Pittsburgh,Baltimore,12/29/2019,Bill Vinovich,12,82,6,47,6,35,15,17,2019
2801,N.Y. Jets,Buffalo,12/29/2019,Brad Rogers,7,53,2,13,5,40,7,17,2019
2802,New Orleans,Carolina,12/29/2019,Ron Torbert,8,98,3,44,5,54,8,17,2019
2803,Cleveland,Cincinnati,12/29/2019,Adrian Hill,7,53,4,33,3,20,7,17,2019
2804,Washington,Dallas,12/29/2019,Craig Wrolstad,12,91,2,10,10,81,15,17,2019
2805,Green Bay,Detroit,12/29/2019,Shawn Hochuli,13,147,9,97,4,50,14,17,2019
2806,Tennessee,Houston,12/29/2019,Clete Blakeman,10,72,5,37,5,35,10,17,2019
2807,Indianapolis,Jacksonville,12/29/2019,Brad Allen,7,63,4,36,3,27,8,17,2019
2808,LA Chargers,Kansas City,12/29/2019,Walt Anderson,13,79,8,40,5,39,15,17,2019
2809,Chicago,Minnesota,12/29/2019,John Hussey,6,74,3,34,3,40,6,17,2019
2810,Miami,New England,12/29/2019,Clay Martin,10,89,4,35,6,54,12,17,2019
2811,Philadelphia,N.Y. Giants,12/29/2019,Alex Kemp,11,103,7,55,4,48,14,17,2019
2812,Atlanta,Tampa Bay,12/29/2019,Carl Cheffers,17,150,5,53,12,97,18,17,2019
2813,Oakland,Denver,12/29/2019,Shawn Smith,19,168,10,107,9,61,21,17,2019
2814,Arizona,LA Rams,12/29/2019,Jerome Boger,18,154,8,63,10,91,19,17,2019
2815,San Francisco,Seattle,12/29/2019,Tony Corrente,13,86,8,57,5,29,13,17,2019
2816,Houston,Kansas City,9/10/2020,Clete Blakeman,6,42,5,37,1,5,6,1,2020
2817,Seattle,Atlanta,9/13/2020,Shawn Hochuli,12,118,6,46,6,72,13,1,2020
2818,Cleveland,Baltimore,9/13/2020,Ron Torbert,15,146,8,80,7,66,15,1,2020
2819,N.Y. Jets,Buffalo,9/13/2020,Shawn Smith,16,175,9,95,7,80,17,1,2020
2820,Las Vegas,Carolina,9/13/2020,Brad Allen,8,105,3,40,5,65,10,1,2020
2821,Chicago,Detroit,9/13/2020,Alex Kemp,14,125,6,48,8,77,17,1,2020
2822,Indianapolis,Jacksonville,9/13/2020,John Hussey,11,141,5,80,6,61,15,1,2020
2823,Green Bay,Minnesota,9/13/2020,Bill Vinovich,11,83,6,63,5,20,12,1,2020
2824,Miami,New England,9/13/2020,Adrian Hill,7,82,4,35,3,47,8,1,2020
2825,Philadelphia,Washington,9/13/2020,Brad Rogers,10,75,3,20,7,55,10,1,2020
2826,LA Chargers,Cincinnati,9/13/2020,Clay Martin,13,79,6,35,7,44,16,1,2020
2827,Tampa Bay,New Orleans,9/13/2020,Jerome Boger,15,222,9,103,6,119,15,1,2020
2828,Arizona,San Francisco,9/13/2020,Carl Cheffers,14,155,9,102,5,53,15,1,2020
2829,Dallas,LA Rams,9/13/2020,Tony Corrente,12,84,7,50,5,34,12,1,2020
2830,Pittsburgh,N.Y. Giants,9/14/2020,Craig Wrolstad,7,46,3,21,4,25,7,1,2020
2831,Tennessee,Denver,9/14/2020,Scott Novak,10,93,5,37,5,56,11,1,2020
2832,Cincinnati,Cleveland,9/17/2020,Shawn Smith,12,121,4,45,8,76,14,2,2020
2833,N.Y. Giants,Chicago,9/20/2020,Bill Vinovich,8,68,3,20,5,48,8,2,2020
2834,Atlanta,Dallas,9/20/2020,Brad Rogers,15,126,8,51,7,75,20,2,2020
2835,Detroit,Green Bay,9/20/2020,Clete Blakeman,15,130,7,70,8,60,18,2,2020
2836,Minnesota,Indianapolis,9/20/2020,Alex Kemp,15,138,6,45,9,93,18,2,2020
2837,Buffalo,Miami,9/20/2020,Jerome Boger,9,75,6,55,3,20,12,2,2020
2838,San Francisco,N.Y. Jets,9/20/2020,Ron Torbert,10,124,5,59,5,65,12,2,2020
2839,LA Rams,Philadelphia,9/20/2020,Brad Allen,9,54,4,24,5,30,10,2,2020
2840,Denver,Pittsburgh,9/20/2020,Adrian Hill,14,119,4,30,10,89,15,2,2020
2841,Carolina,Tampa Bay,9/20/2020,John Hussey,14,114,9,77,5,37,17,2,2020
2842,Jacksonville,Tennessee,9/20/2020,Clay Martin,12,90,8,60,4,30,12,2,2020
2843,Washington,Arizona,9/20/2020,Land Clark,17,139,6,42,11,97,19,2,2020
2844,Baltimore,Houston,9/20/2020,Tony Corrente,7,43,3,21,4,22,8,2,2020
2845,Kansas City,LA Chargers,9/20/2020,Carl Cheffers,17,130,11,90,6,40,19,2,2020
2846,New England,Seattle,9/20/2020,Craig Wrolstad,11,80,2,12,9,68,12,2,2020
2847,New Orleans,Las Vegas,9/21/2020,Shawn Hochuli,13,142,10,129,3,13,18,2,2020
2848,Miami,Jacksonville,9/24/2020,Brad Allen,14,114,6,51,8,63,16,3,2020
2849,Chicago,Atlanta,9/27/2020,Jerome Boger,17,155,10,80,7,75,19,3,2020
2850,LA Rams,Buffalo,9/27/2020,Alex Kemp,8,85,3,30,5,55,12,3,2020
2851,Washington,Cleveland,9/27/2020,Shawn Hochuli,10,90,4,40,6,50,11,3,2020
2852,Tennessee,Minnesota,9/27/2020,Clete Blakeman,7,65,4,45,3,20,9,3,2020
2853,Las Vegas,New England,9/27/2020,Ron Torbert,8,73,6,40,2,33,11,3,2020
2854,San Francisco,N.Y. Giants,9/27/2020,Clay Martin,11,73,6,45,5,28,14,3,2020
2855,Cincinnati,Philadelphia,9/27/2020,Adrian Hill,20,166,9,73,11,93,21,3,2020
2856,Houston,Pittsburgh,9/27/2020,Shawn Smith,6,63,4,49,2,14,6,3,2020
2857,N.Y. Jets,Indianapolis,9/27/2020,Craig Wrolstad,11,97,7,57,4,40,11,3,2020
2858,Carolina,LA Chargers,9/27/2020,Tony Corrente,11,90,3,30,8,60,13,3,2020
2859,Detroit,Arizona,9/27/2020,Scott Novak,14,94,7,46,7,48,16,3,2020
2860,Tampa Bay,Denver,9/27/2020,Land Clark,13,101,9,71,4,30,20,3,2020
2861,Dallas,Seattle,9/27/2020,Carl Cheffers,15,89,10,59,5,30,20,3,2020
2862,Green Bay,New Orleans,9/27/2020,Brad Rogers,10,93,2,10,8,83,11,3,2020
2863,Kansas City,Baltimore,9/28/2020,John Hussey,12,83,6,38,6,45,13,3,2020
2864,Denver,N.Y. Jets,10/1/2020,Jerome Boger,19,212,8,94,11,118,21,4,2020
2865,Arizona,Carolina,10/4/2020,Ron Torbert,15,101,5,29,10,72,16,4,2020
2866,Indianapolis,Chicago,10/4/2020,Craig Wrolstad,16,179,8,76,8,103,17,4,2020
2867,Jacksonville,Cincinnati,10/4/2020,Alex Kemp,13,122,6,49,7,73,17,4,2020
2868,Cleveland,Dallas,10/4/2020,Clay Martin,11,105,5,40,6,65,12,4,2020
2869,New Orleans,Detroit,10/4/2020,Shawn Smith,9,116,4,67,5,49,11,4,2020
2870,Minnesota,Houston,10/4/2020,Brad Rogers,6,51,4,36,2,15,9,4,2020
2871,Seattle,Miami,10/4/2020,Scott Novak,3,20,0,0,3,20,9,4,2020
2872,LA Chargers,Tampa Bay,10/4/2020,Brad Allen,15,150,7,60,8,90,16,4,2020
2873,Baltimore,Washington,10/4/2020,Adrian Hill,7,50,5,30,2,20,8,4,2020
2874,N.Y. Giants,LA Rams,10/4/2020,John Hussey,5,25,4,20,1,5,7,4,2020
2875,New England,Kansas City,10/5/2020,Tony Corrente,8,81,4,43,4,38,8,4,2020
2876,Buffalo,Las Vegas,10/4/2020,Land Clark,12,147,5,81,7,66,16,4,2020
2877,Philadelphia,San Francisco,10/4/2020,Bill Vinovich,9,67,3,25,6,42,10,4,2020
2878,Atlanta,Green Bay,10/5/2020,Carl Cheffers,6,53,3,23,3,30,12,4,2020
2879,Tampa Bay,Chicago,10/8/2020,Alex Kemp,17,175,11,109,6,66,22,5,2020
2880,Carolina,Atlanta,10/11/2020,Brad Allen,7,65,4,25,3,40,11,5,2020
2881,Cincinnati,Baltimore,10/11/2020,Jerome Boger,9,65,5,40,4,25,11,5,2020
2882,Jacksonville,Houston,10/11/2020,Bill Vinovich,9,60,4,35,5,25,9,5,2020
2883,Las Vegas,Kansas City,10/11/2020,Clete Blakeman,18,153,8,59,10,94,19,5,2020
2884,Arizona,N.Y. Jets,10/11/2020,Adrian Hill,16,89,10,59,6,30,18,5,2020
2885,Philadelphia,Pittsburgh,10/11/2020,Ron Torbert,17,170,9,84,8,86,19,5,2020
2886,Buffalo,Tennessee,10/13/2020,Brad Rogers,16,102,10,56,6,46,22,5,2020
2887,LA Rams,Washington,10/11/2020,Shawn Smith,8,100,5,60,3,40,8,5,2020
2888,Miami,San Francisco,10/11/2020,Land Clark,14,144,7,69,7,75,14,5,2020
2889,Indianapolis,Cleveland,10/11/2020,Scott Novak,7,40,5,30,2,10,8,5,2020
2890,N.Y. Giants,Dallas,10/11/2020,Craig Wrolstad,11,106,8,81,3,25,14,5,2020
2891,Minnesota,Seattle,10/11/2020,Tony Corrente,9,80,6,55,3,25,12,5,2020
2892,LA Chargers,New Orleans,10/12/2020,Clay Martin,6,70,1,10,5,60,8,5,2020
2893,Denver,New England,10/18/2020,Scott Novak,3,24,2,20,1,4,4,6,2020
2894,Kansas City,Buffalo,10/19/2020,Ron Torbert,12,107,8,68,4,39,12,6,2020
2895,Chicago,Carolina,10/18/2020,Adrian Hill,18,161,10,92,8,69,18,6,2020
2896,Cincinnati,Indianapolis,10/18/2020,Land Clark,12,75,6,20,6,55,12,6,2020
2897,Detroit,Jacksonville,10/18/2020,Shawn Hochuli,12,116,7,60,5,56,13,6,2020
2898,Atlanta,Minnesota,10/18/2020,Craig Wrolstad,8,55,5,25,3,30,8,6,2020
2899,Washington,N.Y. Giants,10/18/2020,Brad Allen,12,80,8,50,4,30,14,6,2020
2900,Baltimore,Philadelphia,10/18/2020,Shawn Smith,15,152,12,132,3,20,19,6,2020
2901,Cleveland,Pittsburgh,10/18/2020,John Hussey,13,100,7,55,6,45,13,6,2020
2902,Houston,Tennessee,10/18/2020,Alex Kemp,11,119,4,46,7,73,11,6,2020
2903,Green Bay,Tampa Bay,10/18/2020,Jerome Boger,6,76,6,76,0,0,9,6,2020
2904,LA Rams,San Francisco,10/18/2020,Carl Cheffers,13,97,6,34,7,63,15,6,2020
2905,Arizona,Dallas,10/19/2020,Clete Blakeman,13,79,7,43,6,36,15,6,2020
2906,N.Y. Jets,Miami,10/18/2020,Bill Vinovich,12,105,7,80,5,25,16,6,2020
2907,Pittsburgh,Tennessee,10/25/2020,Shawn Hochuli,15,142,8,69,7,73,16,7,2020
2908,N.Y. Giants,Philadelphia,10/22/2020,Adrian Hill,16,137,9,62,7,75,19,7,2020
2909,Detroit,Atlanta,10/25/2020,Land Clark,13,103,5,50,8,53,15,7,2020
2910,Cleveland,Cincinnati,10/25/2020,Tony Corrente,12,85,5,40,7,45,15,7,2020
2911,Green Bay,Houston,10/25/2020,Clay Martin,11,95,5,40,6,55,12,7,2020
2912,Carolina,New Orleans,10/25/2020,Craig Wrolstad,7,55,1,5,6,50,9,7,2020
2913,Buffalo,N.Y. Jets,10/25/2020,Carl Cheffers,17,155,11,106,6,49,19,7,2020
2914,Dallas,Washington,10/25/2020,Ron Torbert,10,79,6,49,4,30,13,7,2020
2915,Seattle,Arizona,10/25/2020,John Hussey,14,118,8,78,6,40,16,7,2020
2916,Kansas City,Denver,10/25/2020,Brad Rogers,6,49,1,15,5,34,10,7,2020
2917,San Francisco,New England,10/25/2020,Shawn Smith,9,95,6,65,3,30,9,7,2020
2918,Tampa Bay,Las Vegas,10/25/2020,Scott Novak,8,55,4,20,4,35,13,7,2020
2919,Chicago,LA Rams,10/26/2020,Bill Vinovich,10,92,6,46,4,46,14,7,2020
2920,Jacksonville,LA Chargers,10/25/2020,Clete Blakeman,9,90,6,55,3,35,9,7,2020
2921,Pittsburgh,Baltimore,11/1/2020,Brad Allen,12,140,3,30,9,110,14,8,2020
2922,Atlanta,Carolina,10/29/2020,Shawn Hochuli,12,93,6,63,6,30,16,8,2020
2923,New England,Buffalo,11/1/2020,Clete Blakeman,10,65,5,35,5,30,11,8,2020
2924,Tennessee,Cincinnati,11/1/2020,Scott Novak,14,113,7,68,7,45,14,8,2020
2925,Las Vegas,Cleveland,11/1/2020,Bill Vinovich,12,84,5,25,7,59,12,8,2020
2926,Indianapolis,Detroit,11/1/2020,Clay Martin,7,95,3,19,4,76,9,8,2020
2927,Minnesota,Green Bay,11/1/2020,Alex Kemp,16,121,7,36,9,85,19,8,2020
2928,N.Y. Jets,Kansas City,11/1/2020,Land Clark,10,86,3,25,7,61,14,8,2020
2929,LA Rams,Miami,11/1/2020,John Hussey,8,75,5,45,3,30,12,8,2020
2930,New Orleans,Chicago,11/1/2020,Tony Corrente,12,98,5,45,7,53,13,8,2020
2931,San Francisco,Seattle,11/1/2020,Craig Wrolstad,12,66,6,36,6,30,14,8,2020
2932,Dallas,Philadelphia,11/1/2020,Jerome Boger,11,96,7,68,4,28,13,8,2020
2933,Tampa Bay,N.Y. Giants,11/2/2020,Brad Rogers,10,93,3,20,7,73,11,8,2020
2934,LA Chargers,Denver,11/1/2020,Carl Cheffers,14,137,6,67,8,70,19,8,2020
2935,Green Bay,San Francisco,11/5/2020,Bill Vinovich,9,78,5,45,4,33,10,9,2020
2936,Denver,Atlanta,11/8/2020,Jerome Boger,10,126,5,65,5,61,15,9,2020
2937,Seattle,Buffalo,11/8/2020,Shawn Smith,10,83,4,13,6,70,12,9,2020
2938,Baltimore,Indianapolis,11/8/2020,Adrian Hill,9,85,5,55,4,30,13,9,2020
2939,Houston,Jacksonville,11/8/2020,Brad Allen,7,96,3,18,4,78,8,9,2020
2940,Carolina,Kansas City,11/8/2020,Clay Martin,20,157,12,82,8,75,22,9,2020
2941,Detroit,Minnesota,11/8/2020,Clete Blakeman,12,106,3,37,9,69,12,9,2020
2942,Chicago,Tennessee,11/8/2020,Ron Torbert,11,92,5,35,6,57,12,9,2020
2943,N.Y. Giants,Washington,11/8/2020,Shawn Hochuli,10,85,4,40,6,45,11,9,2020
2944,Las Vegas,LA Chargers,11/8/2020,Brad Rogers,7,55,2,10,5,45,8,9,2020
2945,Miami,Arizona,11/8/2020,Carl Cheffers,14,146,7,75,7,71,24,9,2020
2946,Pittsburgh,Dallas,11/8/2020,Tony Corrente,10,86,3,16,7,70,13,9,2020
2947,New Orleans,Tampa Bay,11/8/2020,John Hussey,8,67,3,28,5,39,8,9,2020
2948,New England,N.Y. Jets,11/9/2020,Alex Kemp,10,113,6,81,4,32,14,9,2020
2949,LA Chargers,Miami,11/15/2020,Jerome Boger,8,46,5,31,3,15,8,10,2020
2950,Indianapolis,Tennessee,11/12/2020,Brad Allen,12,103,9,73,3,30,13,10,2020
2951,Tampa Bay,Carolina,11/15/2020,Land Clark,8,70,3,30,5,40,8,10,2020
2952,Houston,Cleveland,11/15/2020,Ron Torbert,12,112,6,49,6,63,13,10,2020
2953,Washington,Detroit,11/15/2020,Alex Kemp,15,113,6,58,9,55,18,10,2020
2954,Jacksonville,Green Bay,11/15/2020,Shawn Smith,11,121,7,86,4,35,14,10,2020
2955,Philadelphia,N.Y. Giants,11/15/2020,Clay Martin,18,138,11,74,7,64,18,10,2020
2956,Cincinnati,Pittsburgh,11/15/2020,Adrian Hill,12,110,6,65,6,45,13,10,2020
2957,Buffalo,Arizona,11/15/2020,Craig Wrolstad,16,109,9,69,7,40,20,10,2020
2958,Denver,Las Vegas,11/15/2020,Tony Corrente,15,119,7,37,8,82,17,10,2020
2959,Seattle,LA Rams,11/15/2020,Clete Blakeman,8,72,4,23,4,49,9,10,2020
2960,San Francisco,New Orleans,11/15/2020,Brad Rogers,11,112,6,51,5,61,15,10,2020
2961,Baltimore,New England,11/15/2020,Shawn Hochuli,11,82,8,64,3,18,13,10,2020
2962,Minnesota,Chicago,11/16/2020,Scott Novak,5,40,4,35,1,5,5,10,2020
2963,Miami,Denver,11/22/2020,Land Clark,13,120,5,50,8,70,15,11,2020
2964,N.Y. Jets,LA Chargers,11/22/2020,Craig Wrolstad,17,166,8,88,9,78,18,11,2020
2965,Arizona,Seattle,11/19/2020,Tony Corrente,18,194,10,115,8,79,20,11,2020
2966,Tennessee,Baltimore,11/22/2020,Alex Kemp,10,125,4,44,6,81,11,11,2020
2967,Detroit,Carolina,11/22/2020,Ron Torbert,11,65,4,20,7,45,12,11,2020
2968,Philadelphia,Cleveland,11/22/2020,Adrian Hill,8,86,5,33,3,53,11,11,2020
2969,New England,Houston,11/22/2020,John Hussey,12,90,7,55,5,35,14,11,2020
2970,Green Bay,Indianapolis,11/22/2020,Shawn Hochuli,15,161,7,45,8,116,20,11,2020
2971,Pittsburgh,Jacksonville,11/22/2020,Scott Novak,14,147,6,42,8,105,14,11,2020
2972,Atlanta,New Orleans,11/22/2020,Brad Allen,12,88,7,53,5,35,16,11,2020
2973,Cincinnati,Washington,11/22/2020,Shawn Smith,9,80,3,31,6,49,10,11,2020
2974,Dallas,Minnesota,11/22/2020,Bill Vinovich,12,110,4,30,8,80,13,11,2020
2975,Kansas City,Las Vegas,11/22/2020,Carl Cheffers,18,161,10,89,8,72,21,11,2020
2976,LA Rams,Tampa Bay,11/23/2020,Jerome Boger,7,72,5,65,2,7,9,11,2020
2977,Houston,Detroit,11/26/2020,Shawn Smith,14,118,10,74,4,44,20,12,2020
2978,Washington,Dallas,11/26/2020,Clay Martin,10,98,5,53,5,45,10,12,2020
2979,Baltimore,Pittsburgh,12/2/2020,Ron Torbert,12,126,7,86,5,40,12,12,2020
2980,Las Vegas,Atlanta,11/29/2020,Land Clark,17,190,11,141,6,49,20,12,2020
2981,LA Chargers,Buffalo,11/29/2020,Alex Kemp,14,176,5,91,9,85,20,12,2020
2982,N.Y. Giants,Cincinnati,11/29/2020,Carl Cheffers,8,78,5,51,3,27,9,12,2020
2983,Tennessee,Indianapolis,11/29/2020,John Hussey,15,113,9,63,6,50,19,12,2020
2984,Cleveland,Jacksonville,11/29/2020,Jerome Boger,11,71,6,47,5,24,12,12,2020
2985,Carolina,Minnesota,11/29/2020,Brad Rogers,15,110,7,58,8,52,16,12,2020
2986,Arizona,New England,11/29/2020,Bill Vinovich,12,92,6,50,6,42,14,12,2020
2987,Miami,N.Y. Jets,11/29/2020,Adrian Hill,9,94,3,20,6,74,10,12,2020
2988,New Orleans,Denver,11/29/2020,Craig Wrolstad,7,45,5,35,2,10,9,12,2020
2989,San Francisco,LA Rams,11/29/2020,Scott Novak,8,67,5,40,3,27,9,12,2020
2990,Kansas City,Tampa Bay,11/29/2020,Shawn Hochuli,18,139,10,82,8,57,21,12,2020
2991,Chicago,Green Bay,11/29/2020,Clete Blakeman,8,62,5,45,3,17,8,12,2020
2992,Seattle,Philadelphia,11/30/2020,Brad Allen,17,162,8,83,9,79,19,12,2020
2993,Dallas,Baltimore,12/8/2020,Brad Rogers,11,81,7,58,4,23,13,13,2020
2994,New Orleans,Atlanta,12/6/2020,Adrian Hill,11,94,10,79,1,15,12,13,2020
2995,Detroit,Chicago,12/6/2020,Clay Martin,10,65,7,45,3,20,14,13,2020
2996,Indianapolis,Houston,12/6/2020,Scott Novak,10,80,7,50,3,30,12,13,2020
2997,Cincinnati,Miami,12/6/2020,Ron Torbert,14,116,6,62,8,54,23,13,2020
2998,Jacksonville,Minnesota,12/6/2020,Land Clark,16,124,10,83,6,41,17,13,2020
2999,Las Vegas,N.Y. Jets,12/6/2020,Shawn Smith,9,61,3,21,6,40,11,13,2020
3000,Washington,Pittsburgh,12/7/2020,John Hussey,15,107,9,62,6,45,19,13,2020
3001,Cleveland,Tennessee,12/6/2020,Clete Blakeman,18,144,13,92,5,52,20,13,2020
3002,LA Rams,Arizona,12/6/2020,Shawn Hochuli,11,96,6,75,5,21,12,13,2020
3003,N.Y. Giants,Seattle,12/6/2020,Craig Wrolstad,12,76,6,35,6,41,14,13,2020
3004,Philadelphia,Green Bay,12/6/2020,Bill Vinovich,9,70,4,40,5,30,9,13,2020
3005,New England,LA Chargers,12/6/2020,Carl Cheffers,8,45,3,15,5,30,9,13,2020
3006,Denver,Kansas City,12/6/2020,Alex Kemp,9,75,4,31,5,44,11,13,2020
3007,Buffalo,San Francisco,12/7/2020,Tony Corrente,11,93,4,50,7,43,12,13,2020
3008,New England,LA Rams,12/10/2020,Craig Wrolstad,10,62,5,27,5,35,10,14,2020
3009,Denver,Carolina,12/13/2020,Shawn Hochuli,9,66,2,18,7,48,13,14,2020
3010,Houston,Chicago,12/13/2020,Land Clark,13,94,6,50,7,44,14,14,2020
3011,Dallas,Cincinnati,12/13/2020,John Hussey,8,55,5,30,3,25,10,14,2020
3012,Green Bay,Detroit,12/13/2020,Alex Kemp,16,98,12,68,4,30,17,14,2020
3013,Tennessee,Jacksonville,12/13/2020,Adrian Hill,17,158,7,78,10,80,19,14,2020
3014,Kansas City,Miami,12/13/2020,Clay Martin,11,91,8,56,3,35,12,14,2020
3015,Arizona,N.Y. Giants,12/13/2020,Ron Torbert,6,32,4,22,2,10,6,14,2020
3016,Minnesota,Tampa Bay,12/13/2020,Brad Allen,10,105,5,71,5,34,12,14,2020
3017,Indianapolis,Las Vegas,12/13/2020,Clete Blakeman,12,83,6,50,6,33,12,14,2020
3018,N.Y. Jets,Seattle,12/13/2020,Scott Novak,11,85,7,50,4,35,12,14,2020
3019,Atlanta,LA Chargers,12/13/2020,Tony Corrente,10,75,4,35,6,40,11,14,2020
3020,New Orleans,Philadelphia,12/13/2020,Jerome Boger,14,79,8,52,6,27,15,14,2020
3021,Washington,San Francisco,12/13/2020,Carl Cheffers,10,65,5,30,5,35,13,14,2020
3022,Pittsburgh,Buffalo,12/13/2020,Shawn Smith,10,103,3,55,7,48,13,14,2020
3023,Baltimore,Cleveland,12/14/2020,Bill Vinovich,16,144,8,69,8,75,19,14,2020
3024,LA Chargers,Las Vegas,12/17/2020,John Hussey,9,89,3,20,6,69,9,15,2020
3025,Buffalo,Denver,12/19/2020,Clete Blakeman,15,108,8,75,7,33,17,15,2020
3026,Carolina,Green Bay,12/19/2020,Alex Kemp,12,116,7,66,5,50,14,15,2020
3027,Houston,Indianapolis,12/20/2020,Bill Vinovich,9,59,5,24,4,35,9,15,2020
3028,N.Y. Jets,LA Rams,12/20/2020,Tony Corrente,11,104,6,61,5,43,12,15,2020
3029,Detroit,Tennessee,12/20/2020,Jerome Boger,6,55,3,33,3,22,8,15,2020
3030,Tampa Bay,Atlanta,12/20/2020,Brad Rogers,4,38,1,10,3,28,7,15,2020
3031,Jacksonville,Baltimore,12/20/2020,Carl Cheffers,11,107,7,67,4,40,13,15,2020
3032,New England,Miami,12/20/2020,Brad Allen,9,60,2,20,7,40,10,15,2020
3033,Chicago,Minnesota,12/20/2020,Shawn Smith,5,41,4,36,1,5,5,15,2020
3034,Cleveland,N.Y. Giants,12/20/2020,Shawn Hochuli,8,85,6,60,2,25,11,15,2020
3035,Seattle,Washington,12/20/2020,Adrian Hill,10,86,4,45,6,41,12,15,2020
3036,Philadelphia,Arizona,12/20/2020,Craig Wrolstad,18,152,9,69,9,83,19,15,2020
3037,Kansas City,New Orleans,12/20/2020,Scott Novak,15,147,5,54,10,93,18,15,2020
3038,San Francisco,Dallas,12/20/2020,Land Clark,9,97,4,39,5,58,12,15,2020
3039,Pittsburgh,Cincinnati,12/21/2020,Clay Martin,6,46,4,30,2,16,9,15,2020
3040,Minnesota,New Orleans,12/25/2020,Adrian Hill,7,58,3,20,4,38,9,16,2020
3041,San Francisco,Arizona,12/26/2020,Clete Blakeman,8,47,4,27,4,20,8,16,2020
3042,Tampa Bay,Detroit,12/26/2020,Scott Novak,19,182,8,65,11,117,20,16,2020
3043,Denver,LA Chargers,12/27/2020,Shawn Hochuli,12,89,6,44,6,45,12,16,2020
3044,Miami,Las Vegas,12/26/2020,Tony Corrente,9,116,5,76,4,40,10,16,2020
3045,Cleveland,N.Y. Jets,12/27/2020,Land Clark,13,109,6,51,7,58,17,16,2020
3046,N.Y. Giants,Baltimore,12/27/2020,John Hussey,15,100,5,35,10,65,18,16,2020
3047,Cincinnati,Houston,12/27/2020,Brad Rogers,11,81,5,35,6,46,14,16,2020
3048,Chicago,Jacksonville,12/27/2020,Jerome Boger,14,155,4,40,10,115,15,16,2020
3049,Atlanta,Kansas City,12/27/2020,Craig Wrolstad,13,86,7,45,6,41,16,16,2020
3050,Indianapolis,Pittsburgh,12/27/2020,Alex Kemp,15,132,9,83,6,49,16,16,2020
3051,Carolina,Washington,12/27/2020,Carl Cheffers,8,61,3,35,5,26,10,16,2020
3052,LA Rams,Seattle,12/27/2020,Bill Vinovich,10,76,5,45,5,31,13,16,2020
3053,Philadelphia,Dallas,12/27/2020,Shawn Smith,17,188,12,115,5,73,19,16,2020
3054,Tennessee,Green Bay,12/27/2020,Brad Allen,3,15,3,15,0,0,3,16,2020
3055,Buffalo,New England,12/28/2020,Ron Torbert,7,52,3,27,4,25,8,16,2020
3056,Miami,Buffalo,1/3/2021,Bill Vinovich,5,36,2,20,3,16,7,17,2020
3057,New Orleans,Carolina,1/3/2021,Adrian Hill,5,36,4,31,1,5,6,17,2020
3058,Green Bay,Chicago,1/3/2021,Craig Wrolstad,5,46,4,30,1,16,5,17,2020
3059,Baltimore,Cincinnati,1/3/2021,Land Clark,9,78,6,49,3,29,12,17,2020
3060,Pittsburgh,Cleveland,1/3/2021,Jerome Boger,6,34,2,15,4,19,7,17,2020
3061,Minnesota,Detroit,1/3/2021,John Hussey,11,86,4,35,7,51,12,17,2020
3062,LA Chargers,Kansas City,1/3/2021,Clete Blakeman,9,92,4,23,5,69,9,17,2020
3063,N.Y. Jets,New England,1/3/2021,Brad Rogers,9,77,3,30,6,47,10,17,2020
3064,Dallas,N.Y. Giants,1/3/2021,Brad Allen,12,103,6,58,6,45,15,17,2020
3065,Washington,Philadelphia,1/3/2021,Ron Torbert,11,97,5,56,6,41,12,17,2020
3066,Atlanta,Tampa Bay,1/3/2021,Alex Kemp,7,71,4,48,3,23,9,17,2020
3067,Las Vegas,Denver,1/3/2021,Scott Novak,18,139,14,111,4,28,18,17,2020
3068,Tennessee,Houston,1/3/2021,Shawn Hochuli,12,94,6,50,6,44,12,17,2020
3069,Jacksonville,Indianapolis,1/3/2021,Shawn Smith,4,69,3,54,1,15,4,17,2020
3070,Arizona,LA Rams,1/3/2021,Carl Cheffers,11,76,6,38,5,38,14,17,2020
3071,Seattle,San Francisco,1/3/2021,Tony Corrente,6,60,4,35,2,25,10,17,2020
3072,Dallas,Tampa Bay,9/9/2021,Shawn Hochuli,19,161,8,55,11,106,24,1,2021
3073,Philadelphia,Atlanta,9/12/2021,Scott Novak,26,188,14,89,12,99,27,1,2021
3074,Pittsburgh,Buffalo,9/12/2021,John Hussey,13,113,5,32,8,81,16,1,2021
3075,N.Y. Jets,Carolina,9/12/2021,Clay Martin,11,68,5,30,6,38,14,1,2021
3076,Minnesota,Cincinnati,9/12/2021,Adrian Hill,15,131,12,116,3,15,19,1,2021
3077,San Francisco,Detroit,9/12/2021,Brad Rogers,12,124,7,79,5,45,14,1,2021
3078,Jacksonville,Houston,9/12/2021,Land Clark,15,132,10,82,5,50,20,1,2021
3079,Seattle,Indianapolis,9/12/2021,Tony Corrente,9,69,7,53,2,16,9,1,2021
3080,Arizona,Tennessee,9/12/2021,Jerome Boger,15,116,8,59,7,57,19,1,2021
3081,LA Chargers,Washington,9/12/2021,Alex Kemp,14,151,6,94,8,57,17,1,2021
3082,Cleveland,Kansas City,9/12/2021,Bill Vinovich,10,66,5,30,5,36,16,1,2021
3083,Miami,New England,9/12/2021,Clete Blakeman,13,112,5,28,8,84,14,1,2021
3084,Green Bay,New Orleans,9/12/2021,Carl Cheffers,11,69,5,33,6,36,12,1,2021
3085,Denver,N.Y. Giants,9/12/2021,Ron Torbert,9,99,5,51,4,48,11,1,2021
3086,Chicago,LA Rams,9/12/2021,Brad Allen,7,71,3,35,4,36,9,1,2021
3087,Baltimore,Las Vegas,9/13/2021,Shawn Smith,15,133,5,71,10,62,16,1,2021
3088,N.Y. Giants,Washington,9/16/2021,Scott Novak,20,161,11,81,9,80,20,2,2021
3089,New Orleans,Carolina,9/19/2021,Ron Torbert,16,164,11,115,5,49,17,2,2021
3090,Cincinnati,Chicago,9/19/2021,Land Clark,12,127,4,57,8,70,14,2,2021
3091,Houston,Cleveland,9/19/2021,Brad Rogers,14,140,9,78,5,62,19,2,2021
3092,LA Rams,Indianapolis,9/19/2021,Shawn Smith,5,40,2,15,3,25,5,2,2021
3093,Denver,Jacksonville,9/19/2021,Clay Martin,17,171,10,101,7,70,17,2,2021
3094,Buffalo,Miami,9/19/2021,Craig Wrolstad,15,136,6,53,9,83,19,2,2021
3095,New England,N.Y. Jets,9/19/2021,Shawn Hochuli,14,131,6,54,8,77,15,2,2021
3096,San Francisco,Philadelphia,9/19/2021,Brad Allen,13,117,5,60,8,57,15,2,2021
3097,Las Vegas,Pittsburgh,9/19/2021,Jerome Boger,10,83,5,40,5,43,14,2,2021
3098,Minnesota,Arizona,9/19/2021,Bill Vinovich,8,56,3,16,5,40,12,2,2021
3099,Atlanta,Tampa Bay,9/19/2021,Carl Cheffers,15,132,6,49,9,83,15,2,2021
3100,Dallas,LA Chargers,9/19/2021,Tony Corrente,20,175,8,76,12,99,23,2,2021
3101,Tennessee,Seattle,9/19/2021,John Hussey,15,145,5,45,10,100,17,2,2021
3102,Kansas City,Baltimore,9/19/2021,Clete Blakeman,13,101,5,46,8,55,13,2,2021
3103,Detroit,Green Bay,9/20/2021,Adrian Hill,14,128,9,78,5,50,16,2,2021
3104,Carolina,Houston,9/23/2021,Alex Kemp,15,115,8,64,7,51,16,3,2021
3105,Washington,Buffalo,9/26/2021,Tony Corrente,10,68,5,38,5,30,12,3,2021
3106,Chicago,Cleveland,9/26/2021,Ron Torbert,12,142,5,44,7,98,13,3,2021
3107,Baltimore,Detroit,9/26/2021,Scott Novak,13,104,6,69,7,35,15,3,2021
3108,Arizona,Jacksonville,9/26/2021,Shawn Smith,11,98,7,58,4,40,12,3,2021
3109,LA Chargers,Kansas City,9/26/2021,Shawn Hochuli,14,106,8,50,6,56,17,3,2021
3110,New Orleans,New England,9/26/2021,John Hussey,6,45,2,15,4,30,8,3,2021
3111,Atlanta,N.Y. Giants,9/26/2021,Adrian Hill,12,81,4,28,8,53,15,3,2021
3112,Cincinnati,Pittsburgh,9/26/2021,Clete Blakeman,20,162,10,89,10,73,21,3,2021
3113,Indianapolis,Tennessee,9/26/2021,Bill Vinovich,8,90,4,66,4,24,8,3,2021
3114,N.Y. Jets,Denver,9/26/2021,Land Clark,14,139,8,89,6,50,16,3,2021
3115,Miami,Las Vegas,9/26/2021,Carl Cheffers,16,172,8,68,8,104,19,3,2021
3116,Tampa Bay,LA Rams,9/26/2021,Craig Wrolstad,8,45,7,41,1,4,9,3,2021
3117,Seattle,Minnesota,9/26/2021,Clay Martin,8,75,4,35,4,40,8,3,2021
3118,Green Bay,San Francisco,9/26/2021,Jerome Boger,11,173,7,87,4,86,14,3,2021
3119,Philadelphia,Dallas,9/27/2021,Brad Rogers,17,123,13,86,4,37,22,3,2021
3120,Jacksonville,Cincinnati,9/30/2021,Brad Allen,8,48,2,10,6,38,11,4,2021
3121,Washington,Atlanta,10/3/2021,Clay Martin,13,121,6,85,7,36,15,4,2021
3122,Houston,Buffalo,10/3/2021,Ron Torbert,13,130,10,100,3,30,13,4,2021
3123,Detroit,Chicago,10/3/2021,Shawn Smith,11,87,4,26,7,61,16,4,2021
3124,Carolina,Dallas,10/3/2021,Jerome Boger,13,82,6,32,7,50,16,4,2021
3125,Indianapolis,Miami,10/3/2021,Alex Kemp,13,118,8,86,5,32,17,4,2021
3126,Cleveland,Minnesota,10/3/2021,Tony Corrente,14,115,7,73,7,42,14,4,2021
3127,N.Y. Giants,New Orleans,10/3/2021,Brad Rogers,8,60,3,25,5,35,8,4,2021
3128,Tennessee,N.Y. Jets,10/3/2021,Adrian Hill,14,163,8,98,6,65,17,4,2021
3129,Kansas City,Philadelphia,10/3/2021,Land Clark,16,95,7,46,9,49,18,4,2021
3130,Arizona,LA Rams,10/3/2021,Shawn Hochuli,12,99,7,63,5,36,13,4,2021
3131,Seattle,San Francisco,10/3/2021,Carl Cheffers,13,105,5,27,8,78,13,4,2021
3132,Baltimore,Denver,10/3/2021,Craig Wrolstad,10,80,6,55,4,25,13,4,2021
3133,Pittsburgh,Green Bay,10/3/2021,Scott Novak,8,59,5,34,3,25,11,4,2021
3134,Tampa Bay,New England,10/3/2021,Bill Vinovich,15,151,7,74,8,77,15,4,2021
3135,Las Vegas,LA Chargers,10/4/2021,John Hussey,14,163,7,58,7,105,15,4,2021
3136,LA Rams,Seattle,10/7/2021,Ron Torbert,8,105,5,85,3,20,9,5,2021
3137,N.Y. Jets,Atlanta,10/10/2021,Tony Corrente,11,124,7,58,4,66,13,5,2021
3138,Philadelphia,Carolina,10/10/2021,Shawn Hochuli,15,129,6,60,9,69,16,5,2021
3139,Green Bay,Cincinnati,10/10/2021,Bill Vinovich,4,31,2,10,2,21,5,5,2021
3140,New England,Houston,10/10/2021,Scott Novak,13,97,5,27,8,70,13,5,2021
3141,Tennessee,Jacksonville,10/10/2021,Alex Kemp,11,77,7,44,4,33,12,5,2021
3142,Detroit,Minnesota,10/10/2021,Clete Blakeman,10,104,3,30,7,74,11,5,2021
3143,Denver,Pittsburgh,10/10/2021,Brad Rogers,15,126,7,67,8,59,16,5,2021
3144,Miami,Tampa Bay,10/10/2021,Jerome Boger,11,84,5,37,6,47,14,5,2021
3145,New Orleans,Washington,10/10/2021,Shawn Smith,11,82,6,45,5,37,13,5,2021
3146,Cleveland,LA Chargers,10/10/2021,Brad Allen,13,126,7,77,6,49,19,5,2021
3147,Chicago,Las Vegas,10/10/2021,Craig Wrolstad,18,152,8,70,10,82,22,5,2021
3148,San Francisco,Arizona,10/10/2021,Clay Martin,13,122,7,60,6,62,16,5,2021
3149,N.Y. Giants,Dallas,10/10/2021,John Hussey,13,106,5,48,8,58,15,5,2021
3150,Buffalo,Kansas City,10/10/2021,Carl Cheffers,17,158,10,103,7,55,23,5,2021
3151,Indianapolis,Baltimore,10/11/2021,Land Clark,13,119,5,45,8,74,16,5,2021
3152,Tampa Bay,Philadelphia,10/14/2021,Clay Martin,11,161,7,120,4,41,11,6,2021
3153,Miami,Jacksonville,10/17/2021,John Hussey,15,109,7,55,8,54,15,6,2021
3154,LA Chargers,Baltimore,10/17/2021,Bill Vinovich,6,50,4,35,2,15,6,6,2021
3155,Minnesota,Carolina,10/17/2021,Craig Wrolstad,17,126,11,98,6,28,19,6,2021
3156,Green Bay,Chicago,10/17/2021,Brad Rogers,10,105,3,51,7,54,14,6,2021
3157,Cincinnati,Detroit,10/17/2021,Shawn Hochuli,13,108,4,31,9,77,16,6,2021
3158,Houston,Indianapolis,10/17/2021,Jerome Boger,6,35,4,25,2,10,10,6,2021
3159,LA Rams,N.Y. Giants,10/17/2021,Alex Kemp,12,77,7,50,5,27,14,6,2021
3160,Kansas City,Washington,10/17/2021,Adrian Hill,11,91,5,47,6,44,15,6,2021
3161,Arizona,Cleveland,10/17/2021,Carl Cheffers,14,133,5,45,9,88,15,6,2021
3162,Las Vegas,Denver,10/17/2021,Ron Torbert,12,107,6,54,6,53,13,6,2021
3163,Dallas,New England,10/17/2021,Brad Allen,17,162,12,115,5,47,19,6,2021
3164,Seattle,Pittsburgh,10/17/2021,Shawn Smith,11,83,6,45,5,38,12,6,2021
3165,Buffalo,Tennessee,10/18/2021,Clete Blakeman,15,151,8,60,7,91,22,6,2021
3166,Denver,Cleveland,10/21/2021,Adrian Hill,11,75,2,15,9,60,12,7,2021
3167,Cincinnati,Baltimore,10/24/2021,Tony Corrente,6,51,1,5,5,46,7,7,2021
3168,Washington,Green Bay,10/24/2021,Ron Torbert,8,86,4,50,4,36,10,7,2021
3169,Atlanta,Miami,10/24/2021,Scott Novak,9,73,3,29,6,44,14,7,2021
3170,N.Y. Jets,New England,10/24/2021,Brad Rogers,11,124,5,29,6,95,13,7,2021
3171,Carolina,N.Y. Giants,10/24/2021,Carl Cheffers,15,97,7,37,8,60,15,7,2021
3172,Kansas City,Tennessee,10/24/2021,Brad Allen,15,108,9,77,6,31,15,7,2021
3173,Detroit,LA Rams,10/24/2021,Bill Vinovich,12,112,8,77,4,35,16,7,2021
3174,Philadelphia,Las Vegas,10/24/2021,Clete Blakeman,11,102,4,37,7,65,12,7,2021
3175,Houston,Arizona,10/24/2021,Land Clark,15,134,8,80,7,54,15,7,2021
3176,Chicago,Tampa Bay,10/24/2021,Alex Kemp,5,42,4,32,1,10,5,7,2021
3177,Indianapolis,San Francisco,10/24/2021,Craig Wrolstad,13,167,6,45,7,122,17,7,2021
3178,New Orleans,Seattle,10/25/2021,Shawn Hochuli,13,143,7,90,6,53,13,7,2021
3179,Green Bay,Arizona,10/28/2021,Alex Kemp,14,119,7,60,7,59,14,8,2021
3180,Carolina,Atlanta,10/31/2021,Brad Allen,11,91,8,76,3,15,12,8,2021
3181,Miami,Buffalo,10/31/2021,Shawn Smith,18,138,9,58,9,80,22,8,2021
3182,San Francisco,Chicago,10/31/2021,Land Clark,11,85,7,55,4,30,13,8,2021
3183,Pittsburgh,Cleveland,10/31/2021,Shawn Hochuli,13,95,8,65,5,30,17,8,2021
3184,Philadelphia,Detroit,10/31/2021,Tony Corrente,10,65,2,15,8,50,11,8,2021
3185,LA Rams,Houston,10/31/2021,Clay Martin,9,58,3,20,6,38,12,8,2021
3186,Tennessee,Indianapolis,10/31/2021,Carl Cheffers,20,236,11,161,9,75,21,8,2021
3187,Cincinnati,N.Y. Jets,10/31/2021,Craig Wrolstad,13,97,5,51,8,46,15,8,2021
3188,New England,LA Chargers,10/31/2021,Ron Torbert,9,70,4,30,5,40,12,8,2021
3189,Jacksonville,Seattle,10/31/2021,Adrian Hill,17,133,12,93,5,40,17,8,2021
3190,Washington,Denver,10/31/2021,John Hussey,8,64,4,29,4,35,10,8,2021
3191,Tampa Bay,New Orleans,10/31/2021,Clete Blakeman,13,109,11,99,2,10,14,8,2021
3192,Dallas,Minnesota,10/31/2021,Scott Novak,18,153,11,96,7,57,21,8,2021
3193,N.Y. Giants,Kansas City,11/1/2021,Jerome Boger,22,191,10,88,12,103,23,8,2021
3194,N.Y. Jets,Indianapolis,11/4/2021,John Hussey,9,65,7,43,2,22,11,9,2021
3195,Minnesota,Baltimore,11/7/2021,Carl Cheffers,16,168,8,107,8,61,17,9,2021
3196,New England,Carolina,11/7/2021,Clete Blakeman,16,118,6,35,10,83,16,9,2021
3197,Cleveland,Cincinnati,11/7/2021,Scott Novak,14,115,10,84,4,31,17,9,2021
3198,Denver,Dallas,11/7/2021,Bill Vinovich,10,75,5,37,5,38,11,9,2021
3199,Buffalo,Jacksonville,11/7/2021,Land Clark,20,172,12,118,8,54,21,9,2021
3200,Houston,Miami,11/7/2021,Adrian Hill,10,73,8,60,2,13,12,9,2021
3201,Atlanta,New Orleans,11/7/2021,Alex Kemp,16,150,6,76,10,74,17,9,2021
3202,Las Vegas,N.Y. Giants,11/7/2021,Clay Martin,10,100,6,65,4,35,11,9,2021
3203,LA Chargers,Philadelphia,11/7/2021,Jerome Boger,7,55,4,30,3,25,7,9,2021
3204,Green Bay,Kansas City,11/7/2021,Shawn Smith,10,52,4,19,6,33,13,9,2021
3205,Arizona,San Francisco,11/7/2021,Brad Allen,12,119,9,84,3,35,12,9,2021
3206,Tennessee,LA Rams,11/7/2021,Brad Rogers,16,134,4,19,12,115,20,9,2021
3207,Chicago,Pittsburgh,11/8/2021,Tony Corrente,17,145,12,115,5,30,23,9,2021
3208,Baltimore,Miami,11/11/2021,Ron Torbert,15,117,4,20,11,97,17,10,2021
3209,Atlanta,Dallas,11/14/2021,Craig Wrolstad,14,121,6,41,8,80,15,10,2021
3210,Jacksonville,Indianapolis,11/14/2021,Tony Corrente,15,126,8,79,7,47,18,10,2021
3211,Cleveland,New England,11/14/2021,John Hussey,12,88,6,42,6,46,13,10,2021
3212,Buffalo,N.Y. Jets,11/14/2021,Scott Novak,16,119,7,50,9,69,21,10,2021
3213,Detroit,Pittsburgh,11/14/2021,Land Clark,15,143,8,84,7,59,22,10,2021
3214,New Orleans,Tennessee,11/14/2021,Jerome Boger,17,114,9,65,8,49,17,10,2021
3215,Tampa Bay,Washington,11/14/2021,Brad Rogers,9,76,6,43,3,33,10,10,2021
3216,Carolina,Arizona,11/14/2021,Adrian Hill,13,173,9,115,4,58,17,10,2021
3217,Minnesota,LA Chargers,11/14/2021,Clay Martin,17,170,10,118,7,52,18,10,2021
3218,Philadelphia,Denver,11/14/2021,Shawn Hochuli,11,118,7,89,4,29,11,10,2021
3219,Seattle,Green Bay,11/14/2021,Brad Allen,8,82,5,39,3,43,11,10,2021
3220,Kansas City,Las Vegas,11/14/2021,Bill Vinovich,13,102,4,34,9,68,14,10,2021
3221,LA Rams,San Francisco,11/15/2021,Shawn Smith,14,88,5,35,9,53,17,10,2021
3222,New England,Atlanta,11/18/2021,Land Clark,14,131,5,59,9,72,15,11,2021
3223,Indianapolis,Buffalo,11/21/2021,Brad Rogers,10,86,3,30,7,56,14,11,2021
3224,Washington,Carolina,11/21/2021,Bill Vinovich,15,134,8,69,7,65,17,11,2021
3225,Baltimore,Chicago,11/21/2021,Shawn Smith,12,94,6,36,6,58,15,11,2021
3226,Detroit,Cleveland,11/21/2021,Clay Martin,17,149,7,67,10,82,19,11,2021
3227,San Francisco,Jacksonville,11/21/2021,Ron Torbert,9,68,1,12,8,56,13,11,2021
3228,Green Bay,Minnesota,11/21/2021,Shawn Hochuli,11,117,8,92,3,25,11,11,2021
3229,Miami,N.Y. Jets,11/21/2021,Alex Kemp,15,110,8,62,7,48,18,11,2021
3230,New Orleans,Philadelphia,11/21/2021,Scott Novak,9,74,3,25,6,49,11,11,2021
3231,Houston,Tennessee,11/21/2021,Tony Corrente,12,102,7,50,5,52,14,11,2021
3232,Cincinnati,Las Vegas,11/21/2021,Jerome Boger,8,82,1,5,7,77,8,11,2021
3233,Dallas,Kansas City,11/21/2021,John Hussey,12,109,6,45,6,64,14,11,2021
3234,Arizona,Seattle,11/21/2021,Clete Blakeman,5,49,3,32,2,17,10,11,2021
3235,Pittsburgh,LA Chargers,11/21/2021,Carl Cheffers,20,113,8,38,12,75,23,11,2021
3236,N.Y. Giants,Tampa Bay,11/22/2021,Craig Wrolstad,10,69,4,30,6,39,11,11,2021
3237,Chicago,Detroit,11/25/2021,Adrian Hill,15,117,5,50,10,67,19,12,2021
3238,Las Vegas,Dallas,11/25/2021,Shawn Hochuli,28,276,14,110,14,166,33,12,2021
3239,Buffalo,New Orleans,11/25/2021,Brad Allen,8,59,4,35,4,24,9,12,2021
3240,Pittsburgh,Cincinnati,11/28/2021,Bill Vinovich,7,48,4,30,3,18,10,12,2021
3241,N.Y. Jets,Houston,11/28/2021,Clete Blakeman,9,72,5,40,4,32,11,12,2021
3242,Tampa Bay,Indianapolis,11/28/2021,Shawn Smith,10,110,4,44,6,66,12,12,2021
3243,Atlanta,Jacksonville,11/28/2021,Carl Cheffers,11,69,5,26,6,43,13,12,2021
3244,Carolina,Miami,11/28/2021,John Hussey,12,96,7,61,5,35,12,12,2021
3245,Tennessee,New England,11/28/2021,Alex Kemp,9,85,5,50,4,35,10,12,2021
3246,Philadelphia,N.Y. Giants,11/28/2021,Ron Torbert,6,41,4,26,2,15,6,12,2021
3247,LA Chargers,Denver,11/28/2021,Land Clark,14,110,9,75,5,35,15,12,2021
3248,LA Rams,Green Bay,11/28/2021,Craig Wrolstad,7,62,4,30,3,32,12,12,2021
3249,Minnesota,San Francisco,11/28/2021,Brad Rogers,10,95,5,38,5,57,11,12,2021
3250,Cleveland,Baltimore,11/28/2021,Jerome Boger,10,99,5,45,5,54,12,12,2021
3251,Seattle,Washington,11/29/2021,Clay Martin,10,89,6,51,4,38,13,12,2021
3252,Dallas,New Orleans,12/2/2021,Brad Rogers,12,94,5,35,7,59,14,13,2021
3253,Tampa Bay,Atlanta,12/5/2021,Tony Corrente,9,54,3,15,6,39,9,13,2021
3254,Arizona,Chicago,12/5/2021,Jerome Boger,14,108,8,63,6,45,17,13,2021
3255,LA Chargers,Cincinnati,12/5/2021,Shawn Hochuli,14,114,7,51,7,63,17,13,2021
3256,Minnesota,Detroit,12/5/2021,Craig Wrolstad,10,77,7,66,3,11,10,13,2021
3257,Indianapolis,Houston,12/5/2021,Ron Torbert,9,50,5,25,4,25,11,13,2021
3258,Denver,Kansas City,12/5/2021,Carl Cheffers,12,97,5,37,7,60,15,13,2021
3259,N.Y. Giants,Miami,12/5/2021,Brad Allen,6,38,3,23,3,15,8,13,2021
3260,Philadelphia,N.Y. Jets,12/5/2021,Clay Martin,9,86,3,20,6,66,10,13,2021
3261,Washington,Las Vegas,12/5/2021,Adrian Hill,12,101,6,47,6,54,15,13,2021
3262,Jacksonville,LA Rams,12/5/2021,Clete Blakeman,10,86,3,39,7,47,10,13,2021
3263,Baltimore,Pittsburgh,12/5/2021,Scott Novak,15,136,10,55,5,81,17,13,2021
3264,San Francisco,Seattle,12/5/2021,Alex Kemp,16,126,10,86,6,40,16,13,2021
3265,New England,Buffalo,12/6/2021,Bill Vinovich,9,67,6,47,3,20,9,13,2021
3266,Pittsburgh,Minnesota,12/9/2021,Clete Blakeman,21,187,10,85,11,102,23,14,2021
3267,Atlanta,Carolina,12/12/2021,Shawn Smith,12,105,6,60,6,45,12,14,2021
3268,San Francisco,Cincinnati,12/12/2021,Craig Wrolstad,8,59,6,40,2,19,8,14,2021
3269,Baltimore,Cleveland,12/12/2021,Brad Rogers,14,167,10,125,4,42,20,14,2021
3270,Seattle,Houston,12/12/2021,Adrian Hill,14,121,8,69,6,52,16,14,2021
3271,Las Vegas,Kansas City,12/12/2021,Brad Allen,17,148,9,85,8,63,18,14,2021
3272,New Orleans,N.Y. Jets,12/12/2021,Land Clark,9,87,4,42,5,45,9,14,2021
3273,Jacksonville,Tennessee,12/12/2021,Bill Vinovich,11,94,9,79,2,15,13,14,2021
3274,Dallas,Washington,12/12/2021,Alex Kemp,14,125,7,60,7,65,23,14,2021
3275,Detroit,Denver,12/12/2021,John Hussey,8,71,6,53,2,18,12,14,2021
3276,N.Y. Giants,LA Chargers,12/12/2021,Tony Corrente,9,59,3,20,6,39,9,14,2021
3277,Buffalo,Tampa Bay,12/12/2021,Scott Novak,11,89,7,65,4,24,15,14,2021
3278,Chicago,Green Bay,12/12/2021,Ron Torbert,10,71,7,41,3,30,12,14,2021
3279,LA Rams,Arizona,12/13/2021,Carl Cheffers,12,94,5,40,7,54,16,14,2021
3280,Kansas City,LA Chargers,12/16/2021,Shawn Smith,9,96,4,36,5,60,11,15,2021
3281,Carolina,Buffalo,12/19/2021,Clete Blakeman,13,122,5,55,8,67,16,15,2021
3282,Las Vegas,Cleveland,12/20/2021,Craig Wrolstad,10,125,7,64,3,61,11,15,2021
3283,New England,Indianapolis,12/18/2021,Carl Cheffers,10,63,8,50,2,13,15,15,2021
3284,N.Y. Jets,Miami,12/19/2021,Ron Torbert,8,77,3,32,5,45,11,15,2021
3285,Washington,Philadelphia,12/21/2021,Tony Corrente,6,73,2,25,4,48,7,15,2021
3286,Green Bay,Baltimore,12/19/2021,Brad Allen,16,132,8,76,8,56,16,15,2021
3287,Arizona,Detroit,12/19/2021,Land Clark,13,132,7,83,6,49,13,15,2021
3288,Houston,Jacksonville,12/19/2021,Alex Kemp,13,105,9,65,4,40,17,15,2021
3289,Dallas,N.Y. Giants,12/19/2021,Jerome Boger,12,79,6,45,6,34,14,15,2021
3290,Tennessee,Pittsburgh,12/19/2021,Brad Rogers,12,98,7,68,5,30,15,15,2021
3291,Cincinnati,Denver,12/19/2021,Adrian Hill,12,98,6,38,6,60,15,15,2021
3292,Atlanta,San Francisco,12/19/2021,Clay Martin,9,64,4,29,5,35,11,15,2021
3293,Seattle,LA Rams,12/21/2021,Shawn Hochuli,12,99,8,65,4,34,14,15,2021
3294,New Orleans,Tampa Bay,12/19/2021,John Hussey,9,71,6,41,3,30,10,15,2021
3295,Minnesota,Chicago,12/20/2021,Scott Novak,16,145,7,54,9,91,17,15,2021
3296,San Francisco,Tennessee,12/23/2021,Shawn Hochuli,11,98,5,41,6,57,15,16,2021
3297,Cleveland,Green Bay,12/25/2021,Alex Kemp,9,67,6,38,3,29,10,16,2021
3298,Indianapolis,Arizona,12/25/2021,Craig Wrolstad,16,125,5,40,11,85,17,16,2021
3299,Detroit,Atlanta,12/26/2021,Ron Torbert,8,45,6,30,2,15,11,16,2021
3300,Tampa Bay,Carolina,12/26/2021,Brad Allen,12,82,6,50,6,32,15,16,2021
3301,Baltimore,Cincinnati,12/26/2021,Clete Blakeman,11,72,6,27,5,45,15,16,2021
3302,LA Chargers,Houston,12/26/2021,Clay Martin,15,119,5,49,10,70,16,16,2021
3303,LA Rams,Minnesota,12/26/2021,John Hussey,3,25,1,5,2,20,4,16,2021
3304,Buffalo,New England,12/26/2021,Shawn Smith,8,75,5,45,3,30,12,16,2021
3305,Jacksonville,N.Y. Jets,12/26/2021,Tony Corrente,9,104,2,10,7,94,11,16,2021
3306,N.Y. Giants,Philadelphia,12/26/2021,Land Clark,17,119,6,40,11,79,17,16,2021
3307,Chicago,Seattle,12/26/2021,Carl Cheffers,15,161,8,73,7,88,19,16,2021
3308,Pittsburgh,Kansas City,12/26/2021,Jerome Boger,10,81,5,40,5,41,11,16,2021
3309,Denver,Las Vegas,12/26/2021,Scott Novak,6,67,3,30,3,37,7,16,2021
3310,Washington,Dallas,12/26/2021,Bill Vinovich,4,28,1,13,3,15,7,16,2021
3311,Miami,New Orleans,12/27/2021,Adrian Hill,14,127,7,65,7,62,17,16,2021
3312,Atlanta,Buffalo,1/2/2022,Land Clark,11,74,4,27,7,47,15,17,2021
3313,N.Y. Giants,Chicago,1/2/2022,Shawn Hochuli,8,61,3,26,5,35,8,17,2021
3314,Kansas City,Cincinnati,1/2/2022,Ron Torbert,15,145,10,83,5,62,19,17,2021
3315,Arizona,Dallas,1/2/2022,Scott Novak,17,133,7,45,10,88,19,17,2021
3316,Las Vegas,Indianapolis,1/2/2022,Brad Rogers,9,66,6,41,3,25,11,17,2021
3317,Jacksonville,New England,1/2/2022,Adrian Hill,6,55,3,25,3,30,7,17,2021
3318,Carolina,New Orleans,1/2/2022,Jerome Boger,6,38,1,5,5,33,8,17,2021
3319,Tampa Bay,N.Y. Jets,1/2/2022,Alex Kemp,6,53,4,39,2,14,11,17,2021
3320,Miami,Tennessee,1/2/2022,Shawn Smith,11,125,5,55,6,70,14,17,2021
3321,Philadelphia,Washington,1/2/2022,Clete Blakeman,7,46,6,42,1,4,7,17,2021
3322,Denver,LA Chargers,1/2/2022,Craig Wrolstad,6,45,3,23,3,22,10,17,2021
3323,Houston,San Francisco,1/2/2022,Carl Cheffers,12,178,5,67,7,111,15,17,2021
3324,LA Rams,Baltimore,1/2/2022,Bill Vinovich,8,59,4,35,4,24,8,17,2021
3325,Detroit,Seattle,1/2/2022,Tony Corrente,9,61,4,30,5,31,11,17,2021
3326,Minnesota,Green Bay,1/2/2022,Clay Martin,4,28,3,23,1,5,6,17,2021
3327,Cleveland,Pittsburgh,1/3/2022,Brad Allen,15,128,10,77,5,51,19,17,2021
3328,Buffalo,LA Rams,9/8/2022,Carl Cheffers,9,65,5,35,4,30,9,1,2022
3329,New Orleans,Atlanta,9/11/2022,Alex Kemp,16,154,8,99,8,55,19,1,2022
3330,Cleveland,Carolina,9/11/2022,Brad Rogers,17,167,9,71,8,96,17,1,2022
3331,San Francisco,Chicago,9/11/2022,Clay Martin,15,123,12,99,3,24,17,1,2022
3332,Pittsburgh,Cincinnati,9/11/2022,Shawn Hochuli,12,86,8,59,4,27,14,1,2022
3333,Philadelphia,Detroit,9/11/2022,Brad Allen,17,126,10,61,7,65,20,1,2022
3334,Indianapolis,Houston,9/11/2022,Land Clark,13,129,7,89,6,40,15,1,2022
3335,New England,Miami,9/11/2022,John Hussey,7,35,3,15,4,20,10,1,2022
3336,Baltimore,N.Y. Jets,9/11/2022,Craig Wrolstad,11,110,5,29,6,81,11,1,2022
3337,Jacksonville,Washington,9/11/2022,Tra Blake,19,153,13,90,6,63,21,1,2022
3338,Kansas City,Arizona,9/11/2022,Scott Novak,8,74,3,25,5,49,10,1,2022
3339,Las Vegas,LA Chargers,9/11/2022,Shawn Smith,8,32,3,11,5,21,9,1,2022
3340,Green Bay,Minnesota,9/11/2022,Bill Vinovich,5,30,2,10,3,20,8,1,2022
3341,N.Y. Giants,Tennessee,9/11/2022,Jerome Boger,15,95,8,45,7,50,16,1,2022
3342,Tampa Bay,Dallas,9/11/2022,Ron Torbert,15,98,5,25,10,73,15,1,2022
3343,Denver,Seattle,9/12/2022,Clete Blakeman,17,183,12,106,5,77,18,1,2022
3344,LA Chargers,Kansas City,9/15/2022,John Hussey,9,79,3,25,6,54,14,2,2022
3345,Miami,Baltimore,9/18/2022,Adrian Hill,9,56,8,51,1,5,13,2,2022
3346,N.Y. Jets,Cleveland,9/18/2022,Tra Blake,13,95,8,57,5,38,15,2,2022
3347,Washington,Detroit,9/18/2022,Bill Vinovich,3,22,2,17,1,5,5,2,2022
3348,Indianapolis,Jacksonville,9/18/2022,Alex Kemp,8,49,5,30,3,19,13,2,2022
3349,Tampa Bay,New Orleans,9/18/2022,Shawn Hochuli,17,161,8,101,9,60,19,2,2022
3350,Carolina,N.Y. Giants,9/18/2022,Ron Torbert,13,100,5,38,8,62,15,2,2022
3351,New England,Pittsburgh,9/18/2022,Land Clark,10,75,7,55,3,20,11,2,2022
3352,Atlanta,LA Rams,9/18/2022,Clay Martin,8,90,5,29,3,61,9,2,2022
3353,Seattle,San Francisco,9/18/2022,Brad Rogers,11,132,10,106,1,26,13,2,2022
3354,Cincinnati,Dallas,9/18/2022,Brad Allen,12,80,7,35,5,45,16,2,2022
3355,Houston,Denver,9/18/2022,Carl Cheffers,21,194,8,94,13,100,25,2,2022
3356,Arizona,Las Vegas,9/18/2022,Clete Blakeman,22,188,12,120,10,68,24,2,2022
3357,Chicago,Green Bay,9/18/2022,Craig Wrolstad,10,75,7,50,3,25,12,2,2022
3358,Tennessee,Buffalo,9/19/2022,Shawn Smith,17,136,9,87,8,49,21,2,2022
3359,Minnesota,Philadelphia,9/19/2022,Scott Novak,13,85,5,25,8,60,15,2,2022
3360,Pittsburgh,Cleveland,9/22/2022,Clay Martin,10,49,5,25,5,24,14,3,2022
3361,New Orleans,Carolina,9/25/2022,Carl Cheffers,11,98,7,58,4,40,14,3,2022
3362,Houston,Chicago,9/25/2022,Clete Blakeman,9,57,3,25,6,32,12,3,2022
3363,Kansas City,Indianapolis,9/25/2022,Shawn Smith,10,79,6,45,4,34,12,3,2022
3364,Buffalo,Miami,9/25/2022,Alex Kemp,11,72,7,52,4,20,14,3,2022
3365,Detroit,Minnesota,9/25/2022,John Hussey,10,74,7,59,3,15,13,3,2022
3366,Baltimore,New England,9/25/2022,Bill Vinovich,5,26,2,10,3,16,7,3,2022
3367,Cincinnati,N.Y. Jets,9/25/2022,Jerome Boger,9,85,5,30,4,55,11,3,2022
3368,Las Vegas,Tennessee,9/25/2022,Brad Rogers,13,129,6,44,7,85,16,3,2022
3369,Philadelphia,Washington,9/25/2022,Ron Torbert,9,100,5,52,4,48,10,3,2022
3370,Jacksonville,LA Chargers,9/25/2022,Craig Wrolstad,9,64,2,10,7,54,11,3,2022
3371,LA Rams,Arizona,9/25/2022,Adrian Hill,12,85,6,35,6,50,13,3,2022
3372,Atlanta,Seattle,9/25/2022,Tra Blake,8,62,2,15,6,47,10,3,2022
3373,Green Bay,Tampa Bay,9/25/2022,Scott Novak,14,105,8,65,6,40,15,3,2022
3374,San Francisco,Denver,9/25/2022,Shawn Hochuli,12,70,7,40,5,30,14,3,2022
3375,Dallas,N.Y. Giants,9/26/2022,Land Clark,16,127,8,70,8,57,21,3,2022
3376,Miami,Cincinnati,9/29/2022,Tra Blake,12,115,6,41,6,74,15,4,2022
3377,Minnesota,New Orleans,10/2/2022,Clete Blakeman,15,137,5,35,10,102,17,4,2022
3378,Cleveland,Atlanta,10/2/2022,Craig Wrolstad,8,66,7,51,1,15,11,4,2022
3379,Buffalo,Baltimore,10/2/2022,Jerome Boger,13,101,4,31,9,70,15,4,2022
3380,Washington,Dallas,10/2/2022,Shawn Smith,15,156,11,136,4,20,16,4,2022
3381,Seattle,Detroit,10/2/2022,Clay Martin,19,135,11,76,8,59,24,4,2022
3382,LA Chargers,Houston,10/2/2022,Alex Kemp,15,128,6,61,9,67,19,4,2022
3383,Tennessee,Indianapolis,10/2/2022,Scott Novak,13,90,6,40,7,50,16,4,2022
3384,Chicago,N.Y. Giants,10/2/2022,Carl Cheffers,12,120,5,65,7,55,14,4,2022
3385,Jacksonville,Philadelphia,10/2/2022,Shawn Hochuli,7,58,4,38,3,20,11,4,2022
3386,N.Y. Jets,Pittsburgh,10/2/2022,Brad Rogers,15,119,7,64,8,55,17,4,2022
3387,Arizona,Carolina,10/2/2022,John Hussey,13,137,7,61,6,76,16,4,2022
3388,New England,Green Bay,10/2/2022,Adrian Hill,11,115,7,75,4,40,13,4,2022
3389,Denver,Las Vegas,10/2/2022,Land Clark,11,75,7,50,4,25,14,4,2022
3390,Kansas City,Tampa Bay,10/2/2022,Bill Vinovich,9,72,4,32,5,40,11,4,2022
3391,LA Rams,San Francisco,10/3/2022,Brad Allen,5,30,1,5,4,25,5,4,2022
3392,Indianapolis,Denver,10/6/2022,Brad Rogers,15,113,8,64,7,49,17,5,2022
3393,N.Y. Giants,Green Bay,10/9/2022,Alex Kemp,13,100,6,63,7,37,14,5,2022
3394,Pittsburgh,Buffalo,10/9/2022,John Hussey,11,82,6,54,5,28,14,5,2022
3395,LA Chargers,Cleveland,10/9/2022,Adrian Hill,10,82,4,17,6,65,13,5,2022
3396,Houston,Jacksonville,10/9/2022,Ron Torbert,10,73,4,25,6,48,13,5,2022
3397,Chicago,Minnesota,10/9/2022,Shawn Hochuli,13,110,6,40,7,70,15,5,2022
3398,Detroit,New England,10/9/2022,Craig Wrolstad,13,128,7,82,6,46,14,5,2022
3399,Seattle,New Orleans,10/9/2022,Brad Allen,18,142,12,85,6,57,21,5,2022
3400,Miami,N.Y. Jets,10/9/2022,Clay Martin,16,207,11,102,5,105,17,5,2022
3401,Atlanta,Tampa Bay,10/9/2022,Jerome Boger,12,100,6,55,6,45,12,5,2022
3402,Tennessee,Washington,10/9/2022,Land Clark,17,140,8,69,9,71,20,5,2022
3403,San Francisco,Carolina,10/9/2022,Shawn Smith,14,83,9,50,5,33,16,5,2022
3404,Philadelphia,Arizona,10/9/2022,Tra Blake,5,45,3,30,2,15,5,5,2022
3405,Dallas,LA Rams,10/9/2022,Bill Vinovich,8,67,5,42,3,25,11,5,2022
3406,Cincinnati,Baltimore,10/9/2022,Scott Novak,10,68,4,20,6,48,11,5,2022
3407,Las Vegas,Kansas City,10/10/2022,Carl Cheffers,16,171,11,99,5,72,18,5,2022
3408,Washington,Chicago,10/13/2022,Adrian Hill,11,78,7,36,4,42,12,6,2022
3409,San Francisco,Atlanta,10/16/2022,Carl Cheffers,10,70,5,30,5,40,10,6,2022
3410,New England,Cleveland,10/16/2022,Scott Novak,19,155,12,92,7,63,19,6,2022
3411,N.Y. Jets,Green Bay,10/16/2022,Clete Blakeman,14,121,7,79,7,42,16,6,2022
3412,Jacksonville,Indianapolis,10/16/2022,Jerome Boger,11,96,4,44,7,52,11,6,2022
3413,Minnesota,Miami,10/16/2022,Brad Rogers,12,117,2,20,10,97,13,6,2022
3414,Cincinnati,New Orleans,10/16/2022,Land Clark,7,64,3,30,4,34,8,6,2022
3415,Baltimore,N.Y. Giants,10/16/2022,Clay Martin,13,99,10,74,3,25,14,6,2022
3416,Tampa Bay,Pittsburgh,10/16/2022,Shawn Smith,13,87,6,42,7,45,17,6,2022
3417,Carolina,LA Rams,10/16/2022,Tra Blake,10,79,3,30,7,49,13,6,2022
3418,Arizona,Seattle,10/16/2022,Shawn Hochuli,12,97,6,53,6,44,15,6,2022
3419,Buffalo,Kansas City,10/16/2022,Brad Allen,12,93,7,35,5,58,16,6,2022
3420,Dallas,Philadelphia,10/16/2022,John Hussey,12,82,10,72,2,10,14,6,2022
3421,Denver,LA Chargers,10/17/2022,Ron Torbert,19,240,10,151,9,89,19,6,2022
3422,New Orleans,Arizona,10/20/2022,Jerome Boger,12,69,8,49,4,20,14,7,2022
3423,Cleveland,Baltimore,10/23/2022,Shawn Smith,9,98,6,45,3,53,10,7,2022
3424,Tampa Bay,Carolina,10/23/2022,Craig Wrolstad,7,45,4,30,3,15,9,7,2022
3425,Atlanta,Cincinnati,10/23/2022,Clete Blakeman,8,39,3,22,5,17,11,7,2022
3426,Detroit,Dallas,10/23/2022,Adrian Hill,15,114,8,59,7,55,16,7,2022
3427,N.Y. Giants,Jacksonville,10/23/2022,Tra Blake,21,148,8,67,13,81,23,7,2022
3428,Indianapolis,Tennessee,10/23/2022,Ron Torbert,6,43,4,28,2,15,9,7,2022
3429,Green Bay,Washington,10/23/2022,Clay Martin,16,123,9,69,7,54,20,7,2022
3430,N.Y. Jets,Denver,10/23/2022,Bill Vinovich,15,119,11,85,4,34,16,7,2022
3431,Houston,Las Vegas,10/23/2022,John Hussey,8,58,3,14,5,44,8,7,2022
3432,Seattle,LA Chargers,10/23/2022,Land Clark,14,138,7,68,7,70,16,7,2022
3433,Kansas City,San Francisco,10/23/2022,Alex Kemp,18,164,8,84,10,80,26,7,2022
3434,Pittsburgh,Miami,10/23/2022,Scott Novak,10,70,5,40,5,30,10,7,2022
3435,Chicago,New England,10/24/2022,Brad Allen,8,65,4,35,4,30,12,7,2022
3436,Baltimore,Tampa Bay,10/27/2022,Carl Cheffers,11,136,7,101,4,35,13,8,2022
3437,Denver,Jacksonville,10/30/2022,Adrian Hill,17,135,12,81,5,54,18,8,2022
3438,Carolina,Atlanta,10/30/2022,Shawn Hochuli,16,138,9,74,7,64,19,8,2022
3439,Chicago,Dallas,10/30/2022,Brad Rogers,12,86,6,45,6,41,13,8,2022
3440,Miami,Detroit,10/30/2022,Alex Kemp,13,85,7,55,6,30,24,8,2022
3441,Arizona,Minnesota,10/30/2022,Brad Allen,20,153,10,67,10,86,24,8,2022
3442,Las Vegas,New Orleans,10/30/2022,Scott Novak,11,86,6,59,5,27,11,8,2022
3443,New England,N.Y. Jets,10/30/2022,Shawn Smith,10,95,6,54,4,41,11,8,2022
3444,Pittsburgh,Philadelphia,10/30/2022,Clete Blakeman,17,120,9,60,8,60,17,8,2022
3445,Tennessee,Houston,10/30/2022,Clay Martin,12,80,6,35,6,45,14,8,2022
3446,Washington,Indianapolis,10/30/2022,Craig Wrolstad,6,77,3,52,3,25,6,8,2022
3447,San Francisco,LA Rams,10/30/2022,John Hussey,7,58,3,8,4,50,8,8,2022
3448,N.Y. Giants,Seattle,10/30/2022,Jerome Boger,9,78,6,53,3,25,9,8,2022
3449,Green Bay,Buffalo,10/30/2022,Ron Torbert,12,93,8,58,4,35,13,8,2022
3450,Cincinnati,Cleveland,10/31/2022,Bill Vinovich,8,62,2,6,6,56,9,8,2022
3451,Philadelphia,Houston,11/3/2022,Craig Wrolstad,8,59,4,31,4,28,9,9,2022
3452,LA Chargers,Atlanta,11/6/2022,John Hussey,7,60,5,45,2,15,9,9,2022
3453,Miami,Chicago,11/6/2022,Ron Torbert,7,130,3,38,4,92,10,9,2022
3454,Carolina,Cincinnati,11/6/2022,Alex Kemp,12,85,7,50,5,35,18,9,2022
3455,Green Bay,Detroit,11/6/2022,Tra Blake,15,143,8,81,7,62,15,9,2022
3456,Las Vegas,Jacksonville,11/6/2022,Bill Vinovich,9,75,5,45,4,30,12,9,2022
3457,Indianapolis,New England,11/6/2022,Clay Martin,6,50,2,15,4,35,8,9,2022
3458,Buffalo,N.Y. Jets,11/6/2022,Land Clark,6,60,3,30,3,30,6,9,2022
3459,Minnesota,Washington,11/6/2022,Jerome Boger,8,68,5,42,3,26,8,9,2022
3460,Seattle,Arizona,11/6/2022,Carl Cheffers,18,111,6,34,12,77,19,9,2022
3461,LA Rams,Tampa Bay,11/6/2022,Shawn Hochuli,11,108,4,53,7,55,13,9,2022
3462,Tennessee,Kansas City,11/6/2022,Clete Blakeman,18,120,8,51,10,69,24,9,2022
3463,Baltimore,New Orleans,11/7/2022,Brad Rogers,10,71,5,31,5,40,10,9,2022
3464,Atlanta,Carolina,11/10/2022,Adrian Hill,14,126,4,37,10,89,18,10,2022
3465,Seattle,Tampa Bay,11/13/2022,John Hussey,10,86,6,46,4,40,10,10,2022
3466,Minnesota,Buffalo,11/13/2022,Craig Wrolstad,14,128,7,64,7,64,15,10,2022
3467,Detroit,Chicago,11/13/2022,Land Clark,11,101,2,15,9,86,12,10,2022
3468,Jacksonville,Kansas City,11/13/2022,Brad Rogers,5,30,5,30,0,0,6,10,2022
3469,Cleveland,Miami,11/13/2022,Shawn Hochuli,11,95,6,52,5,43,13,10,2022
3470,Houston,N.Y. Giants,11/13/2022,Bill Vinovich,12,64,7,40,5,24,18,10,2022
3471,New Orleans,Pittsburgh,11/13/2022,Carl Cheffers,13,114,10,74,3,40,14,10,2022
3472,Denver,Tennessee,11/13/2022,Scott Novak,17,110,8,50,9,60,19,10,2022
3473,Indianapolis,Las Vegas,11/13/2022,Tra Blake,14,99,4,25,10,74,17,10,2022
3474,Dallas,Green Bay,11/13/2022,Brad Allen,15,123,9,83,6,40,20,10,2022
3475,Arizona,LA Rams,11/13/2022,Clete Blakeman,15,96,10,67,5,29,15,10,2022
3476,LA Chargers,San Francisco,11/13/2022,Shawn Smith,6,57,1,5,5,52,10,10,2022
3477,Washington,Philadelphia,11/14/2022,Alex Kemp,12,133,5,58,7,75,13,10,2022
3478,Tennessee,Green Bay,11/17/2022,Bill Vinovich,7,60,2,20,5,40,8,11,2022
3479,Chicago,Atlanta,11/20/2022,Tra Blake,9,69,7,56,2,13,11,11,2022
3480,Carolina,Baltimore,11/20/2022,Jerome Boger,19,159,9,66,10,93,20,11,2022
3481,Cleveland,Buffalo,11/20/2022,Adrian Hill,14,131,6,42,8,89,18,11,2022
3482,Washington,Houston,11/20/2022,Scott Novak,7,51,5,36,2,15,12,11,2022
3483,Philadelphia,Indianapolis,11/20/2022,Land Clark,15,145,7,55,8,90,15,11,2022
3484,N.Y. Jets,New England,11/20/2022,Carl Cheffers,11,70,3,15,8,55,14,11,2022
3485,LA Rams,New Orleans,11/20/2022,Ron Torbert,8,70,6,55,2,15,8,11,2022
3486,Detroit,N.Y. Giants,11/20/2022,Brad Rogers,13,108,5,45,8,63,15,11,2022
3487,Las Vegas,Denver,11/20/2022,Shawn Smith,14,143,9,98,5,45,16,11,2022
3488,Kansas City,LA Chargers,11/20/2022,Shawn Hochuli,8,79,4,54,4,25,9,11,2022
3489,Dallas,Minnesota,11/20/2022,Clay Martin,13,98,6,39,7,59,15,11,2022
3490,Cincinnati,Pittsburgh,11/20/2022,Brad Allen,14,114,6,44,8,70,14,11,2022
3491,San Francisco,Arizona,11/21/2022,Craig Wrolstad,8,80,3,30,5,50,11,11,2022
3492,Buffalo,Detroit,11/24/2022,Clete Blakeman,8,68,5,36,3,32,10,12,2022
3493,N.Y. Giants,Dallas,11/24/2022,Scott Novak,20,152,7,66,13,86,22,12,2022
3494,New England,Minnesota,11/24/2022,Alex Kemp,9,75,6,55,3,20,9,12,2022
3495,Denver,Carolina,11/27/2022,Clay Martin,8,78,4,44,4,34,11,12,2022
3496,Tampa Bay,Cleveland,11/27/2022,Tra Blake,14,112,9,70,5,42,17,12,2022
3497,Baltimore,Jacksonville,11/27/2022,Land Clark,7,39,3,20,4,19,9,12,2022
3498,Houston,Miami,11/27/2022,Jerome Boger,9,80,5,45,4,35,9,12,2022
3499,Chicago,N.Y. Jets,11/27/2022,John Hussey,2,15,1,10,1,5,7,12,2022
3500,Cincinnati,Tennessee,11/27/2022,Carl Cheffers,17,137,9,80,8,57,18,12,2022
3501,Atlanta,Washington,11/27/2022,Brad Rogers,6,48,2,20,4,28,7,12,2022
3502,LA Chargers,Arizona,11/27/2022,Ron Torbert,7,49,4,30,3,19,10,12,2022
3503,Las Vegas,Seattle,11/27/2022,Brad Allen,9,60,7,50,2,10,9,12,2022
3504,LA Rams,Kansas City,11/27/2022,Adrian Hill,8,50,5,25,3,25,8,12,2022
3505,New Orleans,San Francisco,11/27/2022,Shawn Hochuli,13,110,6,46,7,64,18,12,2022
3506,Green Bay,Philadelphia,11/27/2022,Shawn Smith,7,60,4,35,3,25,9,12,2022
3507,Pittsburgh,Indianapolis,11/28/2022,Bill Vinovich,5,39,3,19,2,20,9,12,2022
3508,Buffalo,New England,12/1/2022,Shawn Hochuli,12,109,6,47,6,62,16,13,2022
3509,Pittsburgh,Atlanta,12/4/2022,Ron Torbert,13,78,7,30,6,48,15,13,2022
3510,Denver,Baltimore,12/4/2022,Alex Kemp,7,63,4,48,3,15,8,13,2022
3511,Green Bay,Chicago,12/4/2022,Scott Novak,7,83,2,20,5,63,8,13,2022
3512,Jacksonville,Detroit,12/4/2022,Jerome Boger,6,34,5,24,1,10,6,13,2022
3513,Cleveland,Houston,12/4/2022,Land Clark,11,87,6,56,5,31,15,13,2022
3514,N.Y. Jets,Minnesota,12/4/2022,Clete Blakeman,9,84,6,40,3,44,10,13,2022
3515,Washington,N.Y. Giants,12/4/2022,Brad Allen,11,90,7,56,4,34,13,13,2022
3516,Tennessee,Philadelphia,12/4/2022,Adrian Hill,19,162,7,82,12,80,24,13,2022
3517,Seattle,LA Rams,12/4/2022,Shawn Smith,10,81,6,42,4,39,11,13,2022
3518,Miami,San Francisco,12/4/2022,Tra Blake,12,113,8,68,4,45,13,13,2022
3519,Kansas City,Cincinnati,12/4/2022,John Hussey,10,100,4,35,6,65,12,13,2022
3520,LA Chargers,Las Vegas,12/4/2022,Craig Wrolstad,7,35,4,20,3,15,8,13,2022
3521,Indianapolis,Dallas,12/4/2022,Carl Cheffers,9,131,6,88,3,43,11,13,2022
3522,New Orleans,Tampa Bay,12/5/2022,Clay Martin,10,123,6,84,4,39,11,13,2022
3523,Las Vegas,LA Rams,12/8/2022,Brad Rogers,14,154,7,94,7,60,21,14,2022
3524,N.Y. Jets,Buffalo,12/11/2022,Alex Kemp,12,96,7,61,5,35,15,14,2022
3525,Cleveland,Cincinnati,12/11/2022,Jerome Boger,13,134,9,98,4,36,19,14,2022
3526,Houston,Dallas,12/11/2022,John Hussey,7,35,4,25,3,10,11,14,2022
3527,Minnesota,Detroit,12/11/2022,Ron Torbert,10,76,3,25,7,51,10,14,2022
3528,Philadelphia,N.Y. Giants,12/11/2022,Clete Blakeman,7,43,2,9,5,34,9,14,2022
3529,Baltimore,Pittsburgh,12/11/2022,Adrian Hill,7,61,5,46,2,15,10,14,2022
3530,Jacksonville,Tennessee,12/11/2022,Clay Martin,14,120,9,70,5,50,18,14,2022
3531,Miami,LA Chargers,12/11/2022,Scott Novak,12,90,6,50,6,40,14,14,2022
3532,Carolina,Seattle,12/11/2022,Bill Vinovich,9,64,6,29,3,35,11,14,2022
3533,Tampa Bay,San Francisco,12/11/2022,Brad Allen,10,77,8,62,2,15,11,14,2022
3534,Kansas City,Denver,12/11/2022,Craig Wrolstad,10,108,4,70,6,38,10,14,2022
3535,New England,Arizona,12/12/2022,Shawn Smith,16,128,8,80,8,48,20,14,2022
3536,San Francisco,Seattle,12/15/2022,Alex Kemp,15,139,7,60,8,79,19,15,2022
3537,Miami,Buffalo,12/17/2022,Bill Vinovich,15,102,8,51,7,51,21,15,2022
3538,Baltimore,Cleveland,12/17/2022,Brad Allen,6,57,3,25,3,32,10,15,2022
3539,Indianapolis,Minnesota,12/17/2022,Tra Blake,20,177,11,103,9,74,20,15,2022
3540,Atlanta,New Orleans,12/18/2022,Clete Blakeman,9,76,3,30,6,46,11,15,2022
3541,N.Y. Giants,Washington,12/18/2022,John Hussey,11,70,5,30,6,40,11,15,2022
3542,Pittsburgh,Carolina,12/18/2022,Scott Novak,12,121,7,81,5,40,14,15,2022
3543,Philadelphia,Chicago,12/18/2022,Brad Rogers,8,55,2,25,6,30,11,15,2022
3544,Kansas City,Houston,12/18/2022,Carl Cheffers,14,135,10,102,4,33,17,15,2022
3545,Dallas,Jacksonville,12/18/2022,Shawn Smith,6,55,2,18,4,37,7,15,2022
3546,Detroit,N.Y. Jets,12/18/2022,Craig Wrolstad,8,72,6,52,2,20,14,15,2022
3547,Arizona,Denver,12/18/2022,Jerome Boger,11,77,7,46,4,31,11,15,2022
3548,Tennessee,LA Chargers,12/18/2022,Land Clark,9,82,6,62,3,20,13,15,2022
3549,Cincinnati,Tampa Bay,12/18/2022,Adrian Hill,11,85,4,27,7,58,12,15,2022
3550,New England,Las Vegas,12/18/2022,Ron Torbert,19,120,6,30,13,90,19,15,2022
3551,LA Rams,Green Bay,12/19/2022,Shawn Hochuli,12,156,8,76,4,80,16,15,2022
3552,Jacksonville,N.Y. Jets,12/22/2022,Brad Allen,12,89,3,25,9,64,14,16,2022
3553,Atlanta,Baltimore,12/24/2022,Bill Vinovich,6,54,5,48,1,6,7,16,2022
3554,Detroit,Carolina,12/24/2022,Shawn Hochuli,14,104,4,30,10,74,17,16,2022
3555,Buffalo,Chicago,12/24/2022,Carl Cheffers,11,87,9,72,2,15,11,16,2022
3556,New Orleans,Cleveland,12/24/2022,Brad Rogers,6,60,2,15,4,45,7,16,2022
3557,Seattle,Kansas City,12/24/2022,Clete Blakeman,11,74,6,35,5,39,13,16,2022
3558,N.Y. Giants,Minnesota,12/24/2022,Adrian Hill,9,77,7,63,2,14,9,16,2022
3559,Cincinnati,New England,12/24/2022,Craig Wrolstad,18,144,8,62,10,82,19,16,2022
3560,Houston,Tennessee,12/24/2022,Shawn Smith,9,65,4,35,5,30,13,16,2022
3561,Washington,San Francisco,12/24/2022,Jerome Boger,10,76,6,51,4,25,13,16,2022
3562,Philadelphia,Dallas,12/24/2022,Alex Kemp,6,46,2,10,4,36,10,16,2022
3563,Las Vegas,Pittsburgh,12/24/2022,Tra Blake,5,55,2,20,3,35,5,16,2022
3564,Green Bay,Miami,12/25/2022,Land Clark,13,102,5,40,8,62,13,16,2022
3565,Denver,LA Rams,12/25/2022,Ron Torbert,9,61,6,55,3,6,9,16,2022
3566,Tampa Bay,Arizona,12/25/2022,John Hussey,11,104,5,30,6,74,13,16,2022
3567,LA Chargers,Indianapolis,12/26/2022,Clay Martin,8,71,6,60,2,11,8,16,2022
3568,Dallas,Tennessee,12/29/2022,Shawn Hochuli,13,159,3,35,10,124,15,17,2022
3569,Arizona,Atlanta,1/1/2023,Alex Kemp,13,120,8,50,5,70,14,17,2022
3570,Pittsburgh,Baltimore,1/1/2023,Land Clark,10,73,6,43,4,30,11,17,2022
3571,Chicago,Detroit,1/1/2023,Adrian Hill,9,91,3,49,6,42,11,17,2022
3572,Jacksonville,Houston,1/1/2023,Scott Novak,9,75,2,30,7,45,10,17,2022
3573,Denver,Kansas City,1/1/2023,Tra Blake,8,54,3,23,5,31,9,17,2022
3574,Miami,New England,1/1/2023,Brad Allen,15,110,9,71,6,39,15,17,2022
3575,Indianapolis,N.Y. Giants,1/1/2023,Craig Wrolstad,10,80,7,60,3,20,10,17,2022
3576,New Orleans,Philadelphia,1/1/2023,Jerome Boger,11,69,3,20,8,49,11,17,2022
3577,Carolina,Tampa Bay,1/1/2023,Brad Rogers,16,109,8,58,8,51,17,17,2022
3578,Cleveland,Washington,1/1/2023,Bill Vinovich,8,44,3,20,5,24,11,17,2022
3579,San Francisco,Las Vegas,1/1/2023,Clay Martin,15,120,9,71,6,49,16,17,2022
3580,N.Y. Jets,Seattle,1/1/2023,Ron Torbert,7,35,2,10,5,25,7,17,2022
3581,Minnesota,Green Bay,1/1/2023,Carl Cheffers,9,65,6,35,3,30,11,17,2022
3582,LA Rams,LA Chargers,1/1/2023,Clete Blakeman,5,41,3,22,2,19,9,17,2022
